id,name,rank,sums,games,wins,losses
2252,0050,1607,319054783,198494,99122,99372
4450,deadlygame,1683,118407183,70345,37170,33175
99941,4558,1711,68124843,39806,21128,18678
250,jaca010,1594,49236634,30888,15970,14918
1068,mastachwasta,1594,37185739,23320,11373,11947
3705,la0ganja,1850,37821302,20435,11546,8889
189137,arthass,1407,28682413,20381,10124,10257
1429,skromny18,1982,37504212,18915,11829,7086
66831,zalpl20,1668,30182853,18086,9523,8563
135,krzychoilawa,1698,30703114,18074,13318,4756
605,qferkaczy,1469,26467637,18016,9234,8782
870,zawrat4,1530,27439179,17933,8756,9177
49076,idzpopiwo,1755,29482793,16794,9032,7762
199934,1qwertyy,1708,27306220,15982,7403,8579
744,bonie23,1488,21461781,14420,6541,7879
162984,mortek12,1307,17842628,13643,6784,6859
567,kruq,1922,24900117,12952,7383,5569
148489,redzgred,1735,22082309,12725,7237,5488
448207,adinio,1364,16668256,12220,6242,5978
3363,boca09air,1681,20320453,12083,6565,5518
8669,hazardinho,1851,20760966,11212,6430,4782
128226,treffl,1422,15932947,11198,7431,3767
564,konopa1029,1408,15146435,10755,4550,6205
1062,graszzbotem0,1358,14507688,10678,4800,5878
340,plum100,1527,16252693,10637,6931,3706
524,mariusz0621,1466,15317758,10447,6129,4318
108,rafi1997,1628,16709918,10261,5565,4696
7589,meydey1,1492,14877749,9970,4397,5573
215232,bratower5237,1735,17076042,9840,6249,3591
121233,metmez,1475,14302524,9696,4528,5168
920,leon888,1491,13990643,9382,5117,4265
412851,aspidiske,1547,14468086,9349,4987,4362
371,1rak1,1497,13953687,9316,5026,4290
9655,mmm333,1432,13336504,9309,6795,2514
67419,0l0szkowsky,1262,11531372,9132,4042,5090
969,ciechanoof,1923,17235035,8962,7141,1821
208,sekskobieta,1295,11413252,8807,3969,4838
365404,grajse,1492,13005646,8716,4011,4705
74190,maziulka77,1381,12025429,8702,3447,5255
19,chickenretro,1561,13502826,8648,5247,3401
96,gooodziu,1505,13021392,8647,5170,3477
191541,pablito0521,1348,11357061,8419,4389,4030
109708,dadada2222,1327,11147869,8395,4389,4006
1181,grzegorz0810,1813,14883860,8209,4795,3414
1476,marnab,1419,11412098,8039,4559,3480
19182,martin604,1381,11008107,7968,4190,3778
158,xax1,1350,10743161,7955,4043,3912
104681,algty1988,1512,11449765,7568,4692,2876
331546,forma,1625,12240550,7531,4820,2711
7009,donp3dr0,1520,11429218,7518,3850,3668
102629,w3nar,1401,10506358,7494,3540,3954
51494,emerson27,1422,10454700,7347,4597,2750
1045,krystekoaza,1295,9421610,7275,3071,4204
1616,2pac37,1423,10346473,7270,4431,2839
196,sky123,1813,12756640,7036,3672,3364
6638,router89,1416,9943072,7021,3826,3195
109,andr3i0s,1500,10497380,6995,4479,2516
141083,arkomag,1405,9788568,6962,4240,2722
1008,dan179,1445,9723531,6727,5148,1579
129028,moczym0rda123,1273,8409828,6603,2831,3772
126526,zupoloszka,1339,8750873,6535,3305,3230
52125,zigi50,1446,9438774,6526,3846,2680
753,konko07,1435,9252551,6444,3975,2469
500,chmu,1397,8902589,6370,2947,3423
179946,anakonda77,1277,8090382,6334,3167,3167
172845,widm0szeryf,1830,11325479,6188,3616,2572
23609,paauliix3,1331,8178771,6143,3215,2928
478260,bekbek,1552,9486908,6111,3237,2874
144457,szymi84,1367,8329407,6092,2256,3836
1402,0tages0,1744,10584156,6068,3091,2977
7731,nazstrike,1645,9950017,6048,3370,2678
48653,adamsz113,1466,8832720,6024,3138,2886
81955,tomek1082,1324,7908220,5972,2822,3150
121,lorakkkkk,1570,9300051,5921,3356,2565
456,antyamant,1475,8696646,5895,3530,2365
5245,daniell2003,1465,8616311,5879,3210,2669
8890,baterflaj,1391,8086958,5810,2859,2951
236760,pnt1808g,1256,7249055,5770,2911,2859
138315,oikos,1457,8402142,5766,3150,2616
162939,igmar25,1285,7385036,5747,3018,2729
38837,sajan101,1382,7942715,5745,3151,2594
218,orzel44,1635,9389585,5742,3146,2596
116240,henio21,1290,7362641,5704,2713,2991
30448,7mj7,1447,8100864,5595,2689,2906
1593,barcafanklub,1673,9279684,5544,2798,2746
3050,lepikos,1605,8848772,5513,3095,2418
807,kolega111,1336,7233095,5411,3641,1770
16859,zimolator,1375,7347071,5343,2747,2596
23130,bickicycki92,1691,8816598,5211,3131,2080
126756,kazakman,1437,7481475,5205,2294,2911
213,engineeeer,1562,8125237,5200,3011,2189
87900,jakubpiekary,1563,8130755,5200,1760,3440
210102,monika118,1388,7148539,5150,3184,1966
313765,pepexl,1315,6638173,5047,2687,2360
514698,gmb9115g,1341,6746254,5030,2869,2161
75436,wojak1g,1714,8610720,5023,2952,2071
1521,ateista25,1627,8130173,4994,2378,2616
203137,pfb9069g,1384,6859764,4955,1923,3032
582,robo0188,1615,7974713,4936,3913,1023
105883,krzych531,1357,6674117,4916,2455,2461
4175,sadzpallegal,1423,6914843,4857,1849,3008
14903,suchy095,1534,7449107,4853,2660,2193
253,dapper,1463,7041448,4810,3126,1684
240659,rubikon1,1389,6555326,4718,2537,2181
915,1red1,1511,7092264,4692,2192,2500
515727,fanbarcaklub,1604,7480712,4662,2125,2537
24,bjpenn1,1518,7038319,4634,2491,2143
112254,pawelek2008,1349,6254411,4634,2444,2190
10360,cyc222,1522,7041583,4624,2613,2011
385209,uzi1500,1638,7571531,4620,2164,2456
1540,koczis69,1635,7549803,4616,2852,1764
77640,jesteembogiem,1671,7658733,4583,2450,2133
197485,zat0x,1736,7892181,4544,2641,1903
404542,goldziu,1435,6510274,4536,1808,2728
3058,boh1,1371,6182956,4507,2214,2293
137912,puchatypampuh,1808,8141426,4503,2649,1854
86285,nordloft,1313,5899370,4493,2740,1753
1095,mozart1756,1359,6085055,4475,2045,2430
85,v0009,1504,6734569,4475,2232,2243
2469,deszczognia,1533,6773660,4416,1659,2757
359102,asg4rd,1607,7084981,4407,2475,1932
1710,szczepan129,1527,6728906,4405,2323,2082
421802,bronx,1606,7059033,4393,1898,2495
116772,pewniewygras,1624,7052359,4342,2974,1368
52170,bartekziel,1394,6051091,4340,2311,2029
243840,warsaw1916,1285,5529521,4302,2142,2160
247994,pfn5244g,1465,6280976,4286,2452,1834
186924,sigma80,1388,5943863,4281,2367,1914
510,mkb2089,1400,5971701,4264,2497,1767
476984,mgg3919g,1449,6134155,4232,2367,1865
1206,obrzy,1520,6421283,4223,2219,2004
162474,npb6631,1580,6657046,4213,2130,2083
94440,slodek,1884,7888491,4187,2531,1656
429558,mazek18,1390,5806072,4176,2607,1569
112661,remik74,1501,6246096,4161,3093,1068
1753,indroariel,1498,6232671,4160,2015,2145
14099,jotem59,1327,5520361,4157,2336,1821
591,radualexx,1306,5421170,4148,2308,1840
281140,dodeq,1440,5964774,4140,2397,1743
248378,mgs5334g,1351,5591136,4137,1918,2219
7054,marekls,1499,6187426,4127,2166,1961
21940,pawel,1464,6027566,4116,2035,2081
6522,12345b,1402,5770413,4114,2444,1670
5160,kiniu537,1424,5816371,4083,1672,2411
6017,slawekkijowski,1732,7061616,4076,2790,1286
111418,kristofer78,1270,5111728,4024,2205,1819
461,burrito,1494,5987419,4007,2599,1408
21103,mosiek2,1354,5422893,4003,2018,1985
110555,gitarzysta77,1349,5359930,3971,1978,1993
28861,rutkowski26,1246,4948114,3970,1864,2106
670,usa1981,1423,5643464,3964,2126,1838
9926,phallus,1453,5758751,3961,2120,1841
41203,eeeeeeeeeeeeeeee,1700,6705623,3944,2233,1711
89211,unkiu,1404,5516617,3928,2843,1085
333745,kryst1an,1787,7011534,3923,2383,1540
939,malaj21,1520,5958924,3920,2296,1624
361009,ielektryk,1273,4961164,3895,1893,2002
1124,lisapator,1445,5631110,3895,2241,1654
1591,adams142,1399,5445397,3891,2634,1257
25715,danielo84,1431,5488189,3835,2162,1673
21861,oczyklaszcza,1538,5899445,3835,1776,2059
19604,johnybomba,1357,5197872,3830,1751,2079
117683,neymaraa,1976,7558615,3825,2811,1014
151700,hanfromtaiwan,1279,4889264,3822,1595,2227
220710,karuzelok,1538,5873106,3817,1545,2272
442124,vlad1313,1255,4790313,3814,1685,2129
129723,amper0220,1277,4869933,3811,1803,2008
115680,stoicaams1974,1331,5061906,3802,2317,1485
147,januszpaw358,1446,5484979,3791,2150,1641
78310,grudos10,1321,5005205,3787,1965,1822
311275,erwd,1297,4906053,3781,1837,1944
13854,szoblers,1714,6477075,3778,2096,1682
3012,zklepy,1763,6576924,3729,2147,1582
280533,ttf7899,1395,5199626,3726,1685,2041
67138,szojeep,1312,4859810,3703,1716,1987
560448,gpexpres,1256,4650905,3702,1958,1744
231202,kochamdomisie,1802,6627799,3677,2194,1483
449302,rumble,1406,5161624,3669,2012,1657
35099,rastaroots,1857,6776003,3647,2196,1451
76859,bandit650,1579,5726937,3626,1840,1786
467192,pilkarz2323,1325,4803695,3624,1326,2298
762,kreon262,1554,5627365,3619,1575,2044
18935,doctorsah,1368,4934980,3607,2132,1475
15964,dzuda24,1299,4684312,3604,2023,1581
559782,ksg9819g,1451,5224966,3600,1792,1808
49229,positiv1,1324,4763933,3598,1962,1636
850,kaki22,1390,4978057,3581,1758,1823
724,meno1,1423,5067923,3561,2743,818
186589,sbt8456,1580,5605162,3546,2004,1542
88,dgezpdg,1822,6452368,3541,2055,1486
661,la2women,1474,5212355,3534,2206,1328
399906,wylooguj,1636,5761811,3520,2161,1359
35,porebianin71,1362,4791273,3517,1845,1672
328770,takilukasz,1981,6935179,3500,2634,866
110637,bimba82,1396,4875098,3490,2243,1247
3867,miro810,1368,4765042,3483,1904,1579
132052,szlus666,1832,6353653,3468,1997,1471
549063,dzikapani,1519,5254797,3459,1838,1621
402408,foxiuuu,1395,4800417,3441,1891,1550
26162,blue1982,1536,5281243,3438,2865,573
2703,greentown,1565,5381536,3437,1903,1534
32001,strife,1805,6190533,3428,1861,1567
5950,seba5x,1460,5001053,3425,2324,1101
4542,skorpion1020,1515,5188398,3424,2648,776
72383,rajcek18,1440,4907450,3407,1725,1682
913,lukasfj02,1432,4873452,3402,1581,1821
118230,summerdreams,1744,5920105,3393,1610,1783
303516,perun89,1396,4736990,3392,1759,1633
359987,f4rciarz,1483,5015973,3382,1894,1488
1686,fabienb,1542,5210257,3378,1841,1537
300837,pilkarz23,1287,4335035,3368,1216,2152
124,hiszpanek42,1293,4353287,3365,1382,1983
217152,helvick,1321,4444955,3363,1855,1508
192946,pdp8726g,1542,5170689,3352,2912,440
12616,ownatorek,1453,4858922,3343,2325,1018
15211,vvirus,1301,4336945,3332,1545,1787
5424,lastone,1599,5320171,3327,1815,1512
30347,polzzydzi,1425,4736769,3324,1508,1816
560077,drobas31,1272,4227035,3321,1692,1629
459496,cassiopeia7,1518,5028505,3312,1707,1605
2231,linksiq,1466,4856465,3312,1691,1621
80,viperstoro,1404,4648684,3310,1839,1471
201783,lleonidas007,1559,5147884,3302,1710,1592
84746,drukarka121,1516,4994564,3293,1712,1581
268288,fds7220g,1233,4050509,3285,1450,1835
41213,ljkaczynski,1564,5114759,3270,2057,1213
600754,zimnepiwko,1408,4605848,3269,1693,1576
9054,axemurderr,1387,4532382,3266,1487,1779
1762,tomas77,1424,4650822,3266,1522,1744
50378,remoo,1463,4769057,3259,1288,1971
3076,koksik543,1220,3943565,3231,1815,1416
137764,gregory6,1338,4321080,3229,1761,1468
2070,interpablo,1564,5024783,3211,1510,1701
475512,pms6304g,1340,4301900,3210,1977,1233
317459,wdn2146,1362,4369543,3207,1892,1315
39837,sirmatthew,1487,4709777,3166,1779,1387
327,maniekbt,1519,4796578,3156,2185,971
88327,patikowa33,1348,4249101,3150,1928,1222
51819,lara100pro,1380,4329278,3136,1868,1268
1720,cinopl,1573,4929399,3133,1680,1453
77336,m3005,1526,4782439,3132,1921,1211
675,nocnywojer,1456,4557528,3130,1524,1606
261319,irass,1478,4625606,3128,1250,1878
525766,przemek8510,1276,3983982,3121,1507,1614
265781,gorgeduszek24,1551,4835655,3117,1802,1315
548435,npt7486g,1401,4353597,3106,1558,1548
19152,bestiahazard,1881,5838167,3103,1814,1289
8115,damianh,1466,4538314,3094,1409,1685
23077,pawelpaczek,1413,4372254,3094,2030,1064
9151,retsmak,1218,3742262,3072,1284,1788
39698,5tomil0lsztyn,1426,4379408,3069,1278,1791
125632,antyneutrino,1434,4402399,3068,1433,1635
91,aniahehe,1554,4722586,3038,2076,962
281,stejtam,1371,4155514,3029,1792,1237
50767,gartas,1495,4528241,3027,1515,1512
179400,liburator,1504,4551493,3026,1533,1493
336746,bylachlodna,1645,4975821,3023,1373,1650
22528,chemik87,1538,4640269,3016,1462,1554
1286,fony10,1356,4082500,3010,1567,1443
313,0909piotr,1407,4235721,3009,1744,1265
1162,nierdzewny0810,1267,3815318,3009,1166,1843
3700,niezagram,1585,4762277,3004,1381,1623
20120,karolinka2345,1318,3954999,3000,1545,1455
43720,kolao,1256,3768183,2998,1462,1536
3720,zaba0520,1445,4322402,2990,1450,1540
269881,okrutnaja,1386,4142689,2988,1794,1194
3562,widmoszeryf,1851,5512499,2977,1544,1433
27695,bykowhp,1237,3681513,2976,1490,1486
514652,bft5838g,1438,4280857,2975,1560,1415
48892,mariusz1971,1378,4099195,2973,1948,1025
78117,piotr2304,1394,4128445,2960,1174,1786
21558,ratavuli,1532,4522295,2951,1630,1321
67414,reginspl,1292,3812003,2950,1318,1632
55276,diabelek5454,1494,4398817,2943,1748,1195
101807,twojanoga,1815,5324559,2933,1594,1339
205,zmudek79,1418,4158773,2932,1895,1037
54194,kpd6588,1483,4333085,2921,1517,1404
296284,renesans,1310,3822172,2916,1601,1315
19195,blubo645,1465,4251871,2901,1426,1475
87012,kak00tbghc,1426,4116012,2885,1713,1172
302098,dfc3764,1370,3950208,2883,1584,1299
110,kamilw30,1371,3946734,2878,1644,1234
181744,jarosuaf,1317,3782879,2872,1372,1500
650,gramnafonie,1662,4770250,2870,1356,1514
26401,aruszkin,1377,3948497,2867,1440,1427
107757,perzan1981,1420,4067391,2863,1566,1297
7090,ircol,1397,4000416,2862,1676,1186
20639,grz3sgt,1440,4095285,2843,1140,1703
39207,czarekaug,1314,3719131,2830,1465,1365
232588,mnd8870g,1171,3310041,2825,1037,1788
13781,gieniu,1760,4958686,2817,1239,1578
240018,videra,1442,4055800,2811,1507,1304
105026,mat321,1487,4173864,2806,1180,1626
56769,gawelcs,1347,3779839,2805,1490,1315
122685,fitgirl100pro,1470,4123788,2804,1795,1009
7149,niebieskie01,1641,4600577,2802,1223,1579
51418,ziel0nagora,1795,5032130,2802,1328,1474
293,tatowypusc,1538,4309399,2801,1528,1273
2582,mkdfqw,1299,3638428,2799,1194,1605
438126,trooling,1539,4306740,2797,1524,1273
40,weri35,1466,4091388,2789,1753,1036
310045,typereksts,1388,3871786,2788,1374,1414
4447,renifer05,1410,3926111,2784,1205,1579
52268,sunshine82,1387,3854560,2778,1605,1173
516,zobaczmojopis,1399,3884573,2776,1515,1261
131588,tomek2243,1335,3696053,2768,1456,1312
203327,jagigd,1284,3549945,2763,1216,1547
18482,kerim4997,1287,3558466,2763,1462,1301
218638,belahnabah,1398,3860595,2761,1641,1120
109151,arturbozenka4,1273,3504122,2751,1409,1342
64348,malarka29,1357,3734221,2750,1423,1327
552,natalek21,1236,3395569,2747,1176,1571
574,etnic,1489,4088115,2744,1602,1142
88924,brylanto6,1341,3678588,2742,1413,1329
352322,xincognitox,1720,4712622,2739,1681,1058
1383,oprawka,1907,5203685,2728,1949,779
12178,grammatik89,1705,4646348,2725,1416,1309
96919,bomburak,1404,3816903,2718,1897,821
98554,sliniaczek,1899,5149748,2711,1345,1366
1940,remiza665,1400,3779655,2698,1460,1238
3014,d3pr3ch4,1608,4337296,2696,1528,1168
123302,transporter12,1411,3794159,2688,1603,1085
518384,kindahorny,1705,4582824,2687,1543,1144
19274,grayhat,1361,3651319,2682,1475,1207
567972,nowaminuta,1354,3631808,2682,1379,1303
209439,ksc1906jg,1344,3601827,2678,1484,1194
629,xrdmo,1291,3449925,2672,1184,1488
390381,bartek120,1350,3605918,2670,1403,1267
243018,dcf9579,1505,4020656,2670,1473,1197
22939,bishkopcik,1473,3930230,2667,1386,1281
305935,szymek2408,1344,3584133,2665,1298,1367
18701,arent21,1440,3827156,2656,1374,1282
114153,mrsworst,1405,3728866,2653,1477,1176
1973,furty,1368,3621753,2646,1090,1556
526,aligator50,1431,3786643,2645,1537,1108
47394,newbi3,1495,3944961,2638,1309,1329
1371,zbawca,1442,3797806,2633,1455,1178
99541,berta80,1406,3700840,2631,1608,1023
1387,ptysiaczek007,1515,3984703,2630,1522,1108
150795,kukuryku200,1458,3828138,2624,1493,1131
141547,etm233,1613,4222435,2617,2078,539
325676,diabloo23,1382,3616244,2615,1456,1159
32036,amerog,1473,3852378,2614,1335,1279
95161,potuczkin,1978,5169521,2613,1999,614
4322,jimhenson,1445,3775217,2611,1206,1405
12705,0123pele0123,1474,3844354,2607,1201,1406
105,pablopavo,1388,3614980,2604,1375,1229
2591,emilbiernacki123,1456,3787704,2600,1729,871
147053,bbd3132g,1378,3583529,2599,1623,976
92774,danielg1982,1445,3751502,2595,1218,1377
187785,seradin,1491,3866253,2592,1640,952
866,archmarcin,1292,3346913,2590,1303,1287
62430,laser84,1316,3382271,2569,1051,1518
281477,c0stam,1799,4618421,2566,1502,1064
82249,maciekdesire,1348,3457161,2564,1313,1251
487,candidate,1455,3725890,2560,1613,947
23981,budowaogame,1474,3755475,2547,1254,1293
101084,adamkasper,1404,3561093,2536,1504,1032
19602,mcczapa,1471,3725488,2532,1103,1429
346796,monopoli,1643,4151130,2526,1407,1119
314861,hiv2000a,1491,3747120,2513,1245,1268
486020,koller187,1372,3440494,2506,1091,1415
87007,fevo,1383,3464781,2505,1397,1108
394381,nowyrank,1557,3893602,2500,1167,1333
95,kirunia10,1383,3446467,2492,1440,1052
208625,vrurghl,1396,3470396,2485,1344,1141
514331,ngt8112g,1407,3495141,2484,1041,1443
3759,libura,1493,3691290,2472,1225,1247
549757,33rafal33,1291,3183078,2464,1204,1260
15235,maloneygunns,1371,3374736,2460,1213,1247
380,sojahseh,1519,3735984,2459,1301,1158
3038,irass75,1411,3470262,2458,1362,1096
198420,wiezababol,1526,3751373,2457,1404,1053
6014,habakuk16,1618,3967019,2451,1197,1254
664,robaczekk84,1612,3935660,2440,1409,1031
1366,yfthgh,1443,3521745,2440,1513,927
1991,drzunijor,1428,3482834,2438,1217,1221
300310,gtr3,1452,3524764,2426,1460,966
12570,putinoscorbin,1404,3382543,2408,1693,715
82147,hektor001,1284,3086957,2403,1054,1349
1719,sala108,1385,3326508,2401,1077,1324
20664,ki1nga,1428,3425788,2399,1260,1139
148740,jozef6,1322,3171030,2398,1457,941
91803,kasiek1705,1286,3085926,2398,1138,1260
8593,wodnik2101,1410,3361537,2383,1427,956
264,chorynamilosc,1359,3236792,2381,1277,1104
5794,mariunio01,1251,2980294,2381,1151,1230
191,profisport,1448,3445342,2379,1152,1227
53395,mlodyaka,1633,3877100,2374,1178,1196
33820,jarula23,1530,3624956,2369,1289,1080
1191,janiu997,1427,3372466,2363,1472,891
274554,ejno13,1401,3300483,2355,1484,871
314154,radzio0306,1298,3054794,2353,1186,1167
254319,poldekwarpie,1496,3517441,2351,1264,1087
513608,rxv,1581,3719146,2351,1558,793
132690,slawek987,1184,2784550,2350,723,1627
204759,mkg7270g,1461,3426384,2344,1224,1120
3472,mariusz431,1470,3437089,2338,1724,614
397453,soheil68,1317,3072370,2332,1154,1178
623779,soyyomadridis,1443,3365811,2332,1074,1258
85813,pavel555,1382,3216019,2327,1096,1231
355937,kkw9627g,1552,3606651,2323,1506,817
340170,muchanadziiko,1452,3374521,2323,1569,754
10136,nieznanyn,1461,3391242,2321,1108,1213
9769,kolusf9,1313,3045047,2318,1451,867
199381,nbc3730g,1305,3026244,2318,1372,946
117800,sweet,1632,3775627,2313,1455,858
15438,nachtigall88,1406,3229058,2296,1372,924
3427,nazir,1454,3329887,2290,1063,1227
674,matt1,1562,3577706,2289,1445,844
198379,tadeyro74,1391,3181495,2287,1619,668
3353,lightningbol,1685,3853275,2286,1571,715
7683,justadream8,1369,3125452,2282,739,1543
233066,123paw123,1439,3277309,2277,1233,1044
361895,ooloveroo,1349,3072264,2276,1197,1079
64039,szczypiorek07,1196,2719366,2273,809,1464
2167,wrzgliz,1358,3080213,2267,1213,1054
617321,bestialdinho,1812,4107887,2266,1223,1043
1316,gumogniot,1520,3444728,2265,1129,1136
30282,bartkat,1455,3295608,2264,1196,1068
154604,csw769g,1436,3246888,2261,1191,1070
238578,bloodybrute,1298,2929773,2256,1165,1091
4436,janni71,1333,3007205,2255,1165,1090
458975,arti87,1293,2902974,2245,1260,985
200,boogerd,1736,3896546,2244,1265,979
53394,dobratyjol,1560,3502644,2244,1152,1092
15023,tomipltomi,1504,3352492,2228,1423,805
506769,sirmovie,1292,2877517,2227,1456,771
462321,fdf332g,1257,2794463,2222,1143,1079
1135,trol1989,1345,2982106,2216,1010,1206
497429,heisenberg60,1329,2943481,2214,1030,1184
3254,pogromca1000,1543,3417985,2214,1023,1191
239815,dynusxxx23,1420,3137227,2208,1035,1173
6259,krewetka123,1500,3307256,2204,1153,1051
86755,daro012,1421,3132638,2203,1551,652
1483,sylwesterkr,1379,3035736,2200,1095,1105
55439,catan,1417,3115641,2198,999,1199
65947,meter88,1366,2997042,2194,1069,1125
613788,trax0313,1479,3245061,2194,1003,1191
3178,zuza1987r,1823,4001648,2194,1273,921
995,chruszczowiak,1462,3204126,2191,1044,1147
443067,orionidus,1407,3074870,2185,1270,915
106830,dariodar,1441,3146279,2182,1496,686
26503,lomzyniak27,1499,3269431,2180,1082,1098
45852,lukaszek5852,1580,3430212,2171,1133,1038
45340,magdaaa11,1301,2824024,2170,1183,987
40876,snarek34,1558,3368834,2162,1196,966
1038,robcio150,1391,3006643,2161,870,1291
166994,pablinnho,1296,2793175,2155,1052,1103
2792,asia4053,1441,3102637,2153,1412,741
74470,pwm3371g,1386,2982817,2151,1165,986
111726,ee2,1443,3101058,2148,1780,368
195,zyrinowski,1600,3420957,2138,852,1286
1154,magdaa777,1364,2916383,2137,1121,1016
322240,kocurmariana,1431,3050421,2131,1053,1078
10184,iwona71,1297,2761810,2128,1127,1001
1913,franczeska,1532,3258979,2127,1340,787
384,s3ba,1479,3147643,2127,891,1236
5253,ziperziom,1602,3403976,2124,1146,978
567641,idzpopiwko,1788,3789138,2119,1170,949
172450,andyselva,1595,3376707,2116,952,1164
130018,hubert86,1515,3200940,2112,1196,916
68198,monal,1334,2804742,2101,1020,1081
11030,straszny1980,1283,2696572,2101,1255,846
30404,piotrek0405,1498,3145810,2100,1316,784
128850,kartony,1472,3069395,2085,937,1148
153924,zdroju17,1525,3181229,2085,1206,879
97053,bandzirchlast,1787,3706393,2074,1200,874
554694,pitern,1535,3183794,2073,1349,724
314,kroopeq,1452,2998891,2064,907,1157
179130,camillonexx,1280,2642414,2063,981,1082
181120,pawelye,1347,2777107,2061,1166,895
2525,tomixdd,1521,3131543,2058,1051,1007
11686,brtkkrls,1364,2807392,2057,998,1059
14181,eissnimda,1222,2513956,2057,810,1247
23063,niecpaj91,1334,2734963,2050,1139,911
93542,gosiaczek1502,1273,2609946,2049,1081,968
563053,mordini987,1351,2769887,2049,1248,801
495706,c2h50h,1336,2734554,2046,1178,868
51922,ftp3244,1337,2733004,2044,1007,1037
5240,misiocyt87,1284,2617216,2038,981,1057
123419,renols,786,1595700,2029,47,1982
386444,pxxxl,1187,2403236,2023,876,1147
1006,dadada221,1973,3986043,2020,1215,805
539136,rhaegar,1683,3396806,2018,1231,787
926,grzes23l,1569,3160525,2014,1127,887
22863,gosiabedziegr,1259,2535670,2013,894,1119
10703,dar0,1349,2712738,2010,1000,1010
506770,qbawtf,1170,2351701,2010,690,1320
24235,michalarka,1334,2674474,2004,1025,979
52321,gromo22,1755,3516623,2003,1162,841
2367,asdasd007,1672,3344193,2000,1176,824
1687,lubaczow25,1382,2757597,1994,1015,979
679,junior87,1360,2705603,1988,631,1357
2384,goodmis,1442,2865388,1986,997,989
204671,damianmachos,1293,2562890,1981,1100,881
12355,komond,1328,2631857,1981,856,1125
259,dees,1398,2761477,1975,923,1052
855,yogja,1520,3001949,1974,958,1016
118010,shelby601,1589,3120396,1963,878,1085
46218,t4u,1599,3140423,1963,1207,756
7658,anulka1313,1366,2673459,1957,1019,938
120026,kaaczuchaa,1465,2865016,1955,1025,930
25799,siwaa00,1271,2481182,1951,954,997
28974,nier0b,1632,3182574,1950,851,1099
91939,tkb1141,1299,2533910,1950,1038,912
194654,zanonim,1285,2505336,1949,778,1171
77764,illuminati7,1631,3177788,1948,900,1048
120639,nataleandgabi,1558,3035350,1948,1131,817
19169,seetheer,1470,2861387,1946,1473,473
963,wygaba,1491,2902967,1946,1146,800
20087,kaniball,1414,2750258,1945,893,1052
970,wsrryz,1628,3167963,1945,1241,704
205303,srol,1354,2631323,1942,1163,779
14368,doktorsexu,1453,2822059,1941,905,1036
647089,pitbull89,1512,2932388,1939,1468,471
312,malepaluszki,1447,2800842,1935,1141,794
133442,majkaa24,1333,2566981,1925,1080,845
28804,nieznanyslaby,1868,3591702,1922,1133,789
15,alaaa10,1328,2552465,1921,1117,804
1131,herodunio,1362,2615771,1920,1110,810
105503,k307,1322,2539243,1920,1031,889
306180,iskra,1608,3084801,1918,1222,696
763,winzdor,1357,2604588,1918,1104,814
125418,madziuulaaa,1307,2503071,1915,1138,777
9037,dyrektor2,1409,2692059,1910,1048,862
280342,ja1234ty,1491,2848453,1910,1061,849
299078,faarciarz,1484,2830116,1907,1079,828
207950,david1602,1443,2748745,1904,1133,771
104123,dytylywymysy,1464,2784570,1901,1414,487
254408,kkw763g,1475,2801256,1898,926,972
550017,jaqbg,1175,2229180,1897,702,1195
544551,gbf732g,1397,2649113,1896,1226,670
1192,qtrax,1298,2462010,1896,766,1130
218277,urabura1970,1129,2140740,1896,642,1254
109395,kamillllllll,1344,2543987,1892,1172,720
135821,macie20,1435,2715202,1892,849,1043
12615,cartmanhfb,1286,2430616,1890,942,948
1097,gabrysia0007,1454,2745916,1888,993,895
39722,chinskimur1,1422,2677880,1882,964,918
41997,rafalcienias,1550,2917222,1881,1331,550
332414,ppb8672,1452,2729571,1879,844,1035
3215,jacek59bis,1401,2629740,1877,1403,474
246601,waski30,1350,2532573,1875,823,1052
533422,kushrider,1566,2935792,1874,1026,848
216467,kaczka,2022,3787694,1873,1495,378
10624,venturin,1740,3260775,1873,1093,780
36841,acidhouse,1486,2781835,1872,881,991
323625,ataman93,1434,2682704,1870,1206,664
1959,teereefeeree,1652,3083829,1866,931,935
3798,waldifox,1338,2496408,1865,1104,761
827,bwerocko,1877,3495131,1862,1079,783
72568,fereth84,1368,2548271,1862,977,885
117219,lukasramzes,1322,2462128,1862,855,1007
37505,poludniowa52,1458,2711143,1859,1003,856
411060,mastachlasta,1793,3331101,1857,1135,722
54065,jutrosin,1997,3699305,1852,1139,713
175,czarnobyl86,1478,2736723,1851,1088,763
206020,hany145,1330,2463272,1851,966,885
2613,1cloe,1422,2623007,1844,1184,660
1375,denis2002,1566,2887236,1843,1021,822
811,m4ck0,1501,2766539,1842,964,878
171698,taoren,2095,3859449,1842,1509,333
202578,marcin1812,1266,2329829,1839,915,924
1,deniorbl,1475,2710922,1837,1137,700
370706,ike1laik,1821,3346257,1837,1333,504
408054,pizzaztesco,1631,2996320,1837,1344,493
99080,memberofmayday,1564,2871632,1835,887,948
514305,ggf8990g,1357,2487637,1833,1049,784
2125,saruman2222,1509,2767524,1833,1088,745
390649,memphis7mu,1360,2485952,1827,1106,721
53215,bolloyeung,1425,2599060,1823,798,1025
208976,dj987,1420,2581626,1818,967,851
42872,artursierz,1397,2539799,1817,799,1018
286519,nickostatni,1473,2676666,1817,1059,758
173,denalii,1310,2378239,1815,895,920
614,garczek17,1542,2800422,1815,1027,788
364547,nss2056g,1338,2429649,1815,976,839
861,siszarp,1483,2690948,1814,834,980
404443,data,1550,2808724,1811,977,834
463455,krak3rs,1725,3114257,1805,904,901
277943,janecczek,1894,3410045,1800,1389,411
86812,symedos,1785,3213683,1800,1040,760
118,jaroslaw13,1340,2411606,1799,1056,743
17306,jedrek,1334,2399950,1798,939,859
4583,damian0007,1339,2406400,1797,874,923
1989,cougarrpl,1582,2841816,1796,813,983
5818,adampil1,1380,2472719,1791,1079,712
61461,lvlmlvl,1829,3276062,1791,1052,739
98525,brdsrc,1808,3228980,1785,1143,642
766,es91,1542,2753726,1785,897,888
262860,mojroh,1300,2321852,1785,952,833
3270,bobisiek,1340,2391772,1784,1003,781
348910,kacbrand,1471,2624932,1784,1129,655
119906,maciek940,1804,3218152,1783,906,877
510003,mbs3932g,1414,2522576,1783,1034,749
28941,kasiavpek,1576,2809665,1782,1040,742
334955,analffabeta,1257,2238866,1780,856,924
329082,1minuta,1701,3022122,1776,1176,600
114001,mlek0vita,1755,3114852,1774,1000,774
16962,pawelsms,1316,2334109,1773,942,831
215771,marekcbr,1240,2196779,1771,808,963
3775,luq1,1550,2744436,1770,940,830
27933,mateuszek131,1461,2580761,1766,974,792
91676,jerryb,1380,2436321,1765,1245,520
274289,szybkiwladek2,1239,2184471,1762,746,1016
2562,darekpol,1337,2355018,1761,779,982
435918,sawy3r,1514,2656963,1754,938,816
849,ozzysabbath,1351,2369591,1753,912,841
36010,frejus81,1321,2309169,1747,1015,732
547,loco8,1473,2574117,1747,978,769
206010,supersokol,1238,2162359,1746,672,1074
146,sweetweed,1608,2805302,1744,887,857
53923,k0rnik85,1515,2642022,1743,894,849
6053,marinosik,1608,2798807,1740,969,771
22397,ppl55,1433,2493121,1739,871,868
174,n0rules,1448,2512521,1735,841,894
3750,ziutazbagien,1500,2601115,1733,937,796
56135,flores200,1248,2161657,1731,731,1000
181936,turboblue,1196,2071996,1731,592,1139
43368,vebii,1665,2879200,1729,788,941
350481,lepladen,1612,2781568,1725,952,773
2159,fotomen2012,1546,2666669,1724,961,763
244404,fpg958g,1363,2351321,1724,958,766
131495,graszzbotem1,1369,2361722,1724,987,737
246870,piotrrs23,1228,2117000,1723,800,923
4306,regi,1811,3121092,1723,920,803
37567,jaraninho,1524,2623755,1721,766,955
197973,gregory138,1266,2174559,1717,907,810
6011,mirokomo,1354,2324877,1717,868,849
102314,abdabedai,1825,3133259,1716,998,718
45780,lukasz0250,1410,2421160,1716,1055,661
215994,smmol,1593,2731576,1714,863,851
85739,vitrok,1448,2479138,1711,834,877
215517,ggg5462g,1403,2399243,1709,1114,595
691,moti35,1303,2226900,1708,910,798
29,niebieskie02,1613,2754784,1707,765,942
84262,rank,1622,2769422,1707,860,847
156,kolega213,1293,2206039,1706,835,871
339179,mades,1310,2233841,1705,806,899
268400,cejerowski,1320,2250837,1704,901,803
44314,perchfishing,1367,2324240,1700,814,886
36158,przemek707,1268,2155980,1699,855,844
232392,majsterek21,1671,2837614,1698,837,861
715,cigalnica,1317,2228793,1692,711,981
256339,drhouse1910,1316,2224200,1690,866,824
69881,firelock,1650,2790098,1690,961,729
653,13kaza,1312,2214622,1687,804,883
140882,olotrzyko,1664,2807296,1687,903,784
89916,dondrus,1375,2312644,1681,822,859
146333,stefanek85,1247,2093138,1678,802,876
314739,scarabeusz,1484,2490311,1677,1000,677
7010,tomato72,1314,2204408,1677,877,800
56777,gramnatab,1590,2666299,1676,796,880
437,19tyszanie71,1782,2985553,1675,832,843
101043,szymixian,1412,2365787,1675,899,776
77959,mate7,1447,2422638,1674,941,733
4612,bruce100,1396,2336660,1673,1021,652
12789,karolaa181,1187,1986262,1673,637,1036
2920,krzysiek3601,1250,2088830,1671,961,710
390488,kompmacpro13,1388,2316025,1668,953,715
458825,23mj,1437,2388006,1661,774,887
50584,mazi96pl,1437,2387642,1661,978,683
49109,kowsnas,1752,2909394,1660,1058,602
15983,pococitohmm,1429,2368781,1657,838,819
320,rockford,1464,2426619,1657,823,834
79049,mareczek02,1325,2192315,1654,752,902
7472,papadupulos,1461,2412181,1651,1086,565
20665,andrew16,1169,1929763,1650,782,868
54703,futerko1234,1292,2132377,1650,899,751
1500,kalfas,1411,2329272,1650,879,771
116426,no1first,1338,2208899,1650,976,674
486954,rafal1984gda,1442,2379906,1650,903,747
125973,lewandowski87,1428,2355698,1649,941,708
527767,sulej244,1312,2161035,1647,675,972
166762,xxyzyxx,1395,2295811,1645,926,719
286383,kupcia123,1272,2089982,1643,850,793
10010,viri0n,1492,2447142,1640,820,820
5811,zorro911,1351,2215615,1639,821,818
524325,12belinea,1337,2191610,1638,952,686
423165,glitched,1518,2485080,1636,778,858
186838,zygnesejurz,1632,2670094,1636,877,759
163452,dominotor,1292,2109368,1632,799,833
566379,raitza,1627,2656774,1632,1017,615
80580,dobrytrik,1782,2906767,1631,871,760
86942,azrael335,1293,2104472,1627,787,840
106,harvey84,1422,2310605,1624,815,809
390962,gmc1061,1510,2449823,1622,828,794
31503,anecia5044,1394,2259795,1621,691,930
121371,si4nk0,1464,2367707,1617,827,790
13685,aaahhhhh,1627,2630125,1616,805,811
433620,gkk5844g,1319,2130770,1615,921,694
172654,andrzej1047,1257,2029400,1614,808,806
19491,nawrockii2,1522,2455939,1613,878,735
1597,sindbad07,1271,2050920,1613,770,843
116726,wcs2508,1346,2169141,1611,810,801
127925,kroku2000,1763,2838905,1610,955,655
45812,bbkon,1320,2124719,1609,803,806
294203,gfc7501g,1426,2283177,1600,1071,529
663,janiewygrywam,1471,2353426,1599,802,797
4296,fantenisa,1456,2323556,1595,857,738
13490,boiszsiegry,1474,2349952,1594,688,906
692,buli0007,1452,2311658,1591,685,906
449212,kgm5379,1372,2183023,1590,1180,410
8214,piwo4,1326,2108614,1590,743,847
2292,gazela007,1332,2114771,1587,768,819
568240,dbm8282g,1490,2363693,1586,796,790
6426,kugel27,1177,1867446,1586,793,793
367716,czy,1464,2317902,1583,992,591
28629,davtcel,1555,2462659,1583,821,762
94262,gkwg,1347,2133451,1583,620,963
4569,kalisiak41,1527,2417280,1583,753,830
131,toja11111,1266,2004139,1582,718,864
8082,impr,1456,2303485,1581,1322,259
55543,yonday,1371,2168328,1581,838,743
144790,przedtwor,1691,2670691,1579,718,861
64057,marnap,1234,1946251,1577,656,921
5163,paweel0000,1431,2255692,1576,1057,519
282606,wklgfkswko,1350,2128939,1576,872,704
26818,obsobaczony,1421,2238197,1574,799,775
163665,kck920g,1571,2472526,1573,1046,527
456768,dejzewygrac,1387,2177869,1570,720,850
141162,matys19,1494,2344739,1569,867,702
9391,7ronaldo,2004,3138350,1566,1064,502
197248,klapouchy,1294,2025158,1565,732,833
288904,nomen2,1335,2089077,1564,723,841
196079,kogut777,1491,2330950,1563,1163,400
265410,r29gorefest3x,1284,2006401,1562,588,974
92960,pawel500,1379,2147870,1557,691,866
166200,matil95,1740,2707963,1556,1004,552
26427,schumilas,1308,2036467,1556,912,644
14896,cips25,1327,2062681,1554,791,763
132782,cts6275g,1437,2231778,1553,865,688
644581,gnn6380g,1557,2417569,1552,828,724
1212,shemalegirl,1535,2382479,1552,863,689
442051,goralski,1256,1948919,1551,780,771
1786,artek81191,1387,2141689,1544,942,602
10661,ryniu84,1393,2152188,1544,886,658
6065,rafaltwsd,1479,2282655,1543,929,614
9600,kowalbd91,1411,2175954,1542,797,745
483827,wgt4213g,1407,2165787,1539,645,894
88105,marito85,1525,2344187,1537,771,766
1093,halowkarz,1924,2955345,1536,876,660
419727,gie2205,1479,2270987,1535,888,647
559302,avvizo,1364,2091051,1533,946,587
76782,ciuki88,1332,2041424,1532,831,701
7590,brylsi,1476,2258088,1529,777,752
294,monkar55,1422,2173730,1528,743,785
1735,onirycznie,1544,2355405,1525,671,854
56162,p0kap0ka2,1774,2703679,1524,790,734
111775,paulina8216,1423,2169896,1524,752,772
250614,umiyan,1480,2255815,1524,918,606
13394,8skrzat,1287,1960193,1523,887,636
55020,trivet3,1202,1829475,1522,665,857
19859,czesio1991,1274,1937543,1520,723,797
185418,dtk585g,1471,2226853,1513,792,721
28409,ynwa10,1377,2081137,1511,756,755
280279,knp2542g,1464,2211003,1510,695,815
155107,wtm2859g,1562,2358270,1509,847,662
996,faroerianin,1527,2302768,1508,888,620
406117,gobanana,1489,2244791,1507,838,669
7272,olakw128,1264,1905096,1507,719,788
243807,dgf7619g,1457,2191382,1504,1061,443
26674,monter89,1352,2030776,1502,813,689
289290,vints,1347,2024592,1502,804,698
17848,kunegundam,1392,2090877,1501,914,587
292329,abubu,1492,2238287,1500,695,805
514597,tkk633g,1342,2013382,1500,717,783
291315,adb123g,1576,2357761,1496,1196,300
8497,ahjoj,1903,2844139,1494,765,729
561966,lofix,1248,1862112,1491,654,837
318362,gengsta,1348,2007511,1489,831,658
198727,mdc6127g,1365,2033438,1489,586,903
3199,meinfreiheit,1994,2967342,1488,912,576
190809,pwm1601g,1590,2367403,1488,1201,287
306996,bochenuss,1304,1939857,1487,817,670
1439,cyprianb,1436,2135708,1487,756,731
64159,mistrzluuu,1756,2611195,1487,770,717
27143,radek2407,1374,2043901,1487,765,722
581,gregor0777,1313,1951704,1486,699,787
142451,hevisaurus,1629,2420153,1485,744,741
9272,olaf9000,1276,1895352,1485,788,697
544759,fishh,1570,2322753,1479,603,876
45903,maxiuss,1705,2521905,1479,1266,213
37181,sanmarino25,1675,2475907,1478,769,709
42600,suleqpl,1312,1939126,1477,930,547
544,daro21w,1458,2152695,1476,815,661
7776,jadziaa20,1304,1920230,1472,730,742
346301,nkd2466g,1423,2095865,1472,637,835
47666,twardyyy,1804,2650508,1469,680,789
344433,pyzunia43,1326,1947925,1468,828,640
93941,gregory04,1291,1891399,1464,675,789
45718,maquek,1366,1998504,1462,850,612
94605,stachu82w,1381,2018470,1461,833,628
19415,marecki1985,1405,2052164,1460,694,766
162012,prodeal,1350,1971454,1460,745,715
1547,12mistrz34,1454,2118383,1456,697,759
274432,barrabravas1,1496,2179016,1456,780,676
1814,davcel,1533,2230574,1455,750,705
65958,martasz21,1228,1785164,1453,641,812
997,ostatni3konto,1641,2385256,1453,742,711
57932,sebko111,1391,2018485,1451,805,646
34,flippy,1864,2703361,1450,958,492
2036,legendofme,1437,2084617,1450,664,786
882,lowball,1544,2240198,1450,750,700
185620,pedro177,1379,2000608,1450,728,722
41197,amigop,1156,1675322,1449,494,955
638167,michalp108,1370,1986259,1449,679,770
3148,onuc,1302,1886279,1448,676,772
17343,ahmir87,1343,1942595,1446,449,997
1109,amirhossein91,1297,1875467,1446,644,802
519675,kapuch,1370,1981329,1446,737,709
35704,dzalaloddin,2059,2975693,1445,965,480
609,jnicholson,1563,2259847,1445,741,704
64135,kafffar,1310,1893243,1445,869,576
3811,suczka91,1699,2455656,1445,968,477
15557,spidus,1379,1988367,1441,663,778
422414,6woj9,1553,2234383,1438,798,640
483675,nwb8290g,1426,2050761,1438,693,745
495,markowal,1393,1998663,1434,829,605
1110,nudny33,1789,2563869,1433,721,712
2313,pieta666,1414,2027563,1433,856,577
64290,crac0v,1404,2008412,1430,929,501
11467,dusart,1371,1961404,1430,920,510
4028,djvaina,1476,2110623,1429,909,520
222235,krycek10,1306,1865621,1428,851,577
761,duchlast,1701,2424138,1425,791,634
12837,playwithmy,1431,2039976,1425,887,538
13953,kacapcio,1480,2106158,1423,669,754
344201,vitalymo,1609,2290307,1423,946,477
1907,golopolo,1501,2135663,1422,826,596
341,koczkodanson,1492,2119300,1420,798,622
215327,jendrzej22,1520,2154423,1417,646,771
54655,callnoste,1372,1943938,1416,705,711
164910,topteam,1530,2167886,1416,706,710
84114,bryzaj,1472,2084164,1415,938,477
60189,puerto1riko,1303,1842689,1414,737,677
43826,dobrochoczy,1348,1906111,1413,667,746
92819,pozygamsie,1603,2262416,1411,727,684
560,sedah7,1305,1840217,1410,615,795
107285,oli358oli,1423,2000844,1406,778,628
2478,zaborpikas,1392,1955525,1404,850,554
69359,illarramendi,1581,2219513,1403,856,547
50,porobionyy,1369,1921534,1403,768,635
266516,smt6952g,1509,2117303,1403,845,558
82852,osaziomek,1275,1786992,1401,665,736
55714,pustelnik12,1434,2009389,1401,725,676
3168,kulfon200,1262,1765932,1399,663,736
91167,ferniacz,1249,1747027,1398,757,641
596185,graaaa,1343,1877896,1398,802,596
1688,ar3kh3b,1936,2702795,1396,939,457
362320,chceciebje,1346,1879355,1396,680,716
1189,drybler1,1393,1942401,1394,530,864
182110,jarasinho1985,1255,1750084,1394,668,726
415592,ainwel,1502,2093422,1393,972,421
1024,anarchy94,1391,1938909,1393,534,859
16436,apologize6,1595,2220365,1392,586,806
293634,nsf6949g,1337,1861346,1392,709,683
79947,thediablooo,1430,1988913,1390,872,518
421637,piotrek197927,1348,1866810,1384,832,552
18388,monitorfm,1393,1926808,1383,790,593
514261,ktg3958g,1481,2047117,1382,987,395
77754,rudnis91,1267,1749187,1380,614,766
170,necor,1364,1880242,1378,764,614
96793,mlodypx,1388,1911878,1377,820,557
75410,patricos555,1345,1849972,1375,806,569
73621,vastvindsdriften,1402,1928469,1375,756,619
1651,eagleee,1413,1940085,1373,821,552
43103,lalahan,1449,1990718,1373,664,709
113000,smoke2blunts,2074,2848553,1373,996,377
66572,monisia7311,1249,1713909,1372,541,831
463627,idua4a,1502,2058314,1370,784,586
37466,bajus1988,1401,1916782,1368,875,493
546583,dct3275g,1373,1879430,1368,667,701
21686,glonojad69,1339,1832591,1368,635,733
99280,milanista10,1349,1846554,1368,660,708
161490,nenusia2221,1255,1717269,1368,713,655
80824,doooomin,1479,2020446,1366,734,632
138213,major000,1420,1940427,1366,676,690
586764,olenkawnb,1259,1720878,1366,685,681
221084,spyder87,1342,1833978,1366,698,668
107932,beskidian777,1444,1971148,1365,668,697
155704,skat1,1471,2008514,1365,705,660
212234,kft2151g,1330,1814697,1364,677,687
572518,7grudzien92,1557,2122634,1363,708,655
69317,arkadio19,1312,1788343,1363,608,755
191947,lunsil,1372,1869145,1362,652,710
4964,fajkaipiwo,1504,2044413,1359,634,725
630362,mateo4,1449,1970475,1359,646,713
472785,am69,1411,1917490,1358,943,415
11166,deebol1,1372,1862797,1357,693,664
57202,lolciak1702,1280,1736728,1356,806,550
145,dexter05,1703,2308211,1355,715,640
13886,dinamokiev,1454,1971426,1355,826,529
3460,ojejumacieju,1446,1960362,1355,618,737
41521,spirol92,1273,1724982,1355,719,636
246382,rafal0353,1380,1869743,1354,697,657
77503,voleframe,1894,2564992,1354,749,605
185143,gwb8063g,1357,1836318,1353,834,519
1064,trening2012,1425,1922634,1349,653,696
1290,maximuskm,1785,2404469,1347,684,663
206471,karcher99,1397,1881147,1346,657,689
12845,0perator,1653,2222751,1344,654,690
511,hankmoody1,1397,1878332,1344,609,735
11160,ravens89,1293,1737654,1343,600,743
96062,kapitan24,1350,1812213,1342,746,596
25660,gromteraz,1480,1985623,1341,915,426
45593,hitmanbm,1881,2522756,1341,746,595
517,ania20ok,1271,1699463,1337,598,739
6803,dudek37,1370,1827878,1334,801,533
489,jarekbpp,1345,1795204,1334,599,735
548422,dkd5964g,1341,1785930,1331,688,643
337980,4me,1683,2238516,1330,709,621
445025,barczas1989,1353,1800603,1330,679,651
388270,mariuszmichal,1301,1730360,1330,759,571
608938,pkozlow3,1390,1848756,1330,914,416
2885,battlecity,2097,2787432,1329,848,481
459,szrekse,1367,1812441,1325,693,632
232575,muniek1313,1390,1837242,1321,959,362
265877,pazdzioch07,1306,1725292,1321,640,681
70286,isqa,1292,1705775,1320,670,650
173193,lechiagdansk2,1466,1935754,1320,763,557
309711,garfildos,1400,1846263,1318,774,544
75489,kpablito,1328,1748802,1316,717,599
36194,myszkowski,1562,2056586,1316,633,683
32143,dawacrankhamy,1346,1770646,1315,642,673
513445,dj44,1244,1635590,1314,709,605
11641,menf77,1279,1681211,1314,702,612
104018,sedlak90,1470,1931089,1313,727,586
626,gracjann94,1512,1984307,1312,676,636
82902,tomsok3,1498,1965184,1311,616,695
645451,mcs8109,1360,1781384,1309,731,578
321729,dorotawarcaba,1246,1629881,1308,628,680
62182,hajzi1,1208,1580545,1308,548,760
10163,winner55,1275,1668652,1308,655,653
497318,oskar69o,1337,1747689,1307,618,689
1673,aleksanderf,1354,1769285,1306,725,581
1499,lwin,1406,1832822,1303,711,592
16028,virusowo,1273,1659780,1303,593,710
11738,3arturro4,1226,1596843,1302,618,684
227346,pbm6629g,1206,1569112,1301,533,768
757,madefac,1397,1817083,1300,635,665
87642,taterek7,1228,1597000,1300,617,683
481306,aaldi,1272,1652767,1299,549,750
80587,doman,1205,1565729,1299,532,767
11637,biczuuu,1523,1973888,1296,688,608
92,rahowa82,1393,1806042,1296,820,476
2477,sullivan,1843,2386964,1295,683,612
39621,miichal25,1686,2181926,1294,805,489
77802,igroty,1426,1844406,1293,731,562
26428,kawem,1228,1588015,1293,535,758
639883,pavvel24,1282,1657549,1292,731,561
409446,ktn1233g,1636,2112264,1291,825,466
273195,endorfinapl,1410,1817170,1288,831,457
89242,piwosz2004,1213,1562046,1287,579,708
417582,sensej123,1285,1654694,1287,709,578
196152,izuulka91,1235,1588810,1286,583,703
51022,paul4747,1493,1919189,1285,735,550
27165,przegrasztyzn,1395,1790026,1283,572,711
183730,7farciarz,1247,1596836,1280,551,729
1408,arek,1731,2212246,1278,720,558
65590,fanatykproch,1544,1972240,1277,582,695
190187,macias616,1335,1705327,1277,836,441
23698,przechodzien,1660,2120991,1277,643,634
69715,iceman2010,1493,1905461,1276,749,527
53907,whitedarek,1684,2148336,1275,673,602
113365,olkacz,1355,1727058,1274,734,540
501035,pourhomme,1478,1883457,1274,678,596
83908,adelcia92,1555,1979709,1273,686,587
162070,chmka,1285,1636717,1273,636,637
91355,morethan1500,1719,2188871,1273,813,460
201386,tomaluch23,1157,1473625,1273,503,770
125,milano0002,1327,1688104,1272,574,698
2044,owsiak94,1428,1817340,1272,736,536
152310,claudiuvirgil,1203,1528215,1270,551,719
8634,kaczorpt,1270,1613752,1270,706,564
297614,ssm4350g,1272,1616546,1270,648,622
25888,sniosek,1475,1872412,1269,697,572
69582,dotknijdzwiga,1871,2372725,1268,661,607
735,bizarrian,1440,1824814,1267,781,486
1245,jozef85,1327,1681672,1267,730,537
419684,ndg7037g,1405,1779866,1266,751,515
336,wind666,2048,2593467,1266,799,467
584106,boredaf,1638,2071083,1264,729,535
93001,ktydal,1325,1675373,1264,630,634
36679,tomek2265,1212,1533104,1264,582,682
55741,zizou303,1375,1739142,1264,601,663
79625,kempa87,1337,1689312,1263,706,557
55987,koncapri72,1324,1671462,1262,738,524
2356,zajaccount,1434,1808298,1261,604,657
41668,grzebyk,1411,1777116,1259,624,635
18841,djkrzysio,1581,1988932,1258,651,607
552285,fifi85,1271,1599858,1258,646,612
1134,pawlik1306,1399,1760675,1258,711,547
111660,xia0,1363,1715329,1258,618,640
23844,rafalpat93,1504,1889316,1256,680,576
395,wersylalki12,1466,1842251,1256,644,612
8886,dragonow,1486,1863795,1254,525,729
66754,slotslot,1425,1787388,1254,651,603
961,klacjusz81,1355,1698380,1253,552,701
44212,kwadrat24,1496,1871523,1251,601,650
551541,mpf8171g,1391,1740790,1251,681,570
444784,dojadeci,1266,1579470,1247,610,637
497790,kobra26,1449,1807682,1247,708,539
223176,bramkaz,1570,1956658,1246,858,388
595638,mdg5359g,1277,1592294,1246,660,586
264512,witaaamina,1514,1887001,1246,727,519
538448,batnawas,1641,2039962,1243,922,321
125740,diditi,1498,1862983,1243,604,639
17939,patuska1211,1930,2399277,1243,953,290
69503,sds1838,1317,1637390,1243,645,598
162284,erxa,1598,1985504,1242,614,628
2988,tommycz,1559,1934836,1241,727,514
550972,kordel,1321,1637496,1239,646,593
3934,summonus,1489,1845230,1239,558,681
174210,afw,1415,1751950,1238,516,722
614513,mdk4685g,1538,1904660,1238,675,563
160367,fpf988g,1346,1665234,1237,807,430
403,2danie,1392,1720819,1236,638,598
391554,hisems,1604,1982983,1236,900,336
253707,micha2016,1348,1667155,1236,803,433
17385,black8jack,1510,1865257,1235,718,517
361910,magikkarp,1584,1956440,1235,570,665
90168,killerxxx,1399,1725690,1233,686,547
15344,pornostar1,1524,1879355,1233,507,726
237109,daniel85wlkp,1433,1765202,1231,895,336
11046,23azazel,1468,1806367,1230,577,653
2355,aperfectcircle,1468,1805824,1230,714,516
10653,arcziss78,1283,1577164,1229,605,624
61912,michalkita,1226,1507677,1229,547,682
131075,gramnakiblu,1656,2029164,1225,599,626
62972,m1minuta,1888,2311295,1224,715,509
96068,pbt8666,1446,1770625,1224,648,576
6538,waco8,1563,1913112,1224,613,611
267,wania210,1392,1703989,1224,720,504
10873,tommilee,1396,1708003,1223,688,535
33766,dolotsd,1395,1705803,1222,837,385
55,okladka2,1493,1824057,1221,660,561
2939,6359bestia,1820,2221096,1220,590,630
419602,michal790,1270,1549796,1220,685,535
15216,mario400,1306,1593117,1219,598,621
1830,natalcia250,1414,1721945,1217,666,551
218912,najjlepsza,1421,1725533,1214,701,513
3160,hektor0108,1486,1802191,1212,786,426
1075,krzysiek9696,1311,1589710,1212,671,541
6656,87miecio87,1407,1704479,1211,510,701
495139,bkt9320g,1569,1895465,1208,788,420
471631,heisenberg660,1304,1575552,1208,692,516
975,one2one88,1374,1660815,1208,718,490
75405,borys1923,1278,1542934,1207,602,605
128706,musicavemetal,1782,2151681,1207,785,422
40762,elmacabra,1616,1949885,1206,780,426
18348,mlodyoner,1298,1566205,1206,680,526
146042,wolfsin420,1317,1588882,1206,679,527
578675,fwt4488g,1312,1581066,1205,674,531
110939,likelike,1408,1696067,1204,482,722
17506,matrix995,1488,1792751,1204,579,625
24049,mofch,1438,1731664,1204,627,577
74062,lamusypl,1587,1910186,1203,633,570
50070,elpasss,1353,1622599,1199,580,619
2453,karel36,1487,1783446,1199,682,517
343856,dwd1127g,1498,1793940,1197,849,348
579345,wpiernicz,1357,1624466,1197,706,491
52466,baloba15,1080,1292575,1196,327,869
1299,zniew0l0ny,1488,1780338,1196,615,581
115970,wyrywanyzesnu,1579,1887386,1195,546,649
30476,norton82,1601,1907522,1191,655,536
33497,3kopower,1715,2041590,1190,617,573
28649,raff1984,1410,1678535,1190,555,635
535424,wnk4599g,1371,1632076,1190,626,564
67770,kokostudio,1517,1804596,1189,562,627
2769,postrzelony,1425,1692995,1188,741,447
147148,wodzu12d,1266,1504237,1188,569,619
106881,ascerk,1323,1571475,1187,643,544
514469,tdg5247g,1566,1859578,1187,1068,119
550221,spc6409g,1290,1531038,1186,616,570
128223,fcbayern1991,1311,1553857,1185,735,450
3257,grzesiek46,1374,1628667,1185,678,507
119837,karinkovax3,1291,1530645,1185,628,557
2128,leon063,1384,1640341,1185,741,444
732,martitta69,1436,1700465,1184,583,601
1886,dar151515,1541,1823350,1183,737,446
7233,deke,1519,1797288,1183,635,548
416510,goetz,1456,1722629,1183,800,383
21751,wielkieserducho,1211,1431425,1182,500,682
175690,betaxerox,1394,1646623,1181,583,598
91985,skuter21,1391,1642068,1180,585,595
45810,witaminab17,1496,1765677,1180,579,601
77793,lewnia,1452,1712433,1179,775,404
492063,mnn5383g,1546,1822742,1179,694,485
33436,niegadam0gram,1462,1724441,1179,751,428
15415,djmaly89,1452,1710688,1178,612,566
13051,vebkcm,1415,1667707,1178,567,611
540837,ad1000,1455,1711512,1176,656,520
308888,doctordick,1579,1857076,1176,697,479
8461,notorius,1573,1847129,1174,628,546
393995,zagraktokurde,1618,1900170,1174,670,504
65959,adrianm,1289,1513035,1173,700,473
281358,garnuszek,1323,1552389,1173,597,576
495848,dogonito,1373,1610074,1172,577,595
153118,tynotentego,1276,1496291,1172,635,537
61158,aceface007,1308,1531058,1170,668,502
39885,erol23,1512,1769122,1170,590,580
283334,gfp2355g,1414,1653847,1169,669,500
2087,aids2000,1525,1781505,1168,577,591
639,gilbert756,1308,1526712,1167,595,572
20800,mike1247,1646,1921261,1167,1001,166
419001,patt14,1298,1514794,1167,603,564
5110,furt,1365,1591866,1166,477,689
940,goldkart,1325,1545325,1166,609,557
91749,badziewiaki,1567,1825633,1165,719,446
214189,satt,1308,1523214,1164,573,591
234644,mariuszzzuu,1243,1446614,1163,573,590
815,matrixsk,1283,1491247,1162,471,691
54888,czarek20,1365,1585325,1161,625,536
2611,sliniak88,1302,1510754,1160,589,571
49566,polandhulk,1795,2081185,1159,625,534
2407,kng4519,1446,1675044,1158,830,328
132830,16bartek16,1257,1451550,1154,621,533
109765,aden1221,1252,1444927,1154,505,649
478125,btd7449g,1387,1601671,1154,815,339
35848,matias6789,1453,1677119,1154,555,599
475353,ncn7867g,1374,1586200,1154,646,508
883,magictarget,1965,2262156,1151,691,460
475852,ntd3942g,1482,1706323,1151,566,585
190323,nuevaz,1366,1573235,1151,597,554
436,playarena,1944,2238156,1151,715,436
99434,dramowaa,1479,1700874,1150,598,552
375933,npm9730g,1563,1798411,1150,659,491
332431,cysiux,1476,1694995,1148,580,568
187479,swieta,1718,1972457,1148,670,478
142443,jadeit03,1481,1698878,1147,668,479
48096,kms3,1549,1775927,1146,659,487
30659,knurovv,1975,2263828,1146,666,480
305052,emson274,1279,1464864,1145,505,640
559250,smd1938g,1270,1455001,1145,599,546
49275,tomek0309,1257,1440393,1145,549,596
176720,grupabemo,1361,1557554,1144,732,412
168118,orlik1,1291,1475447,1142,561,581
51779,38mir,1241,1416924,1141,594,547
494456,gtg5856,1203,1369578,1138,552,586
280256,emilia1984x,1232,1401122,1137,531,606
383816,thepiggle,1302,1481080,1137,712,425
128910,koss20,1031,1171716,1136,399,737
82931,jakub1445,1353,1534823,1134,657,477
94134,kcwryeti,1279,1451430,1134,547,587
41066,wyle94,1429,1620176,1133,734,399
1652,papatango,1251,1414888,1131,487,644
152069,11pepe11,1652,1867461,1130,510,620
9483,jakubn94,1615,1823747,1129,588,541
210941,dkf3950g,1339,1509093,1127,656,471
230455,karwos9119,1335,1504893,1127,535,592
49956,wyzelek,1489,1678267,1127,624,503
21182,frugasek,1313,1479354,1126,581,545
179469,patrzpooczach,1284,1446154,1126,603,523
127866,dmain90,1284,1444593,1125,652,473
193388,xxxnoname,1870,2102957,1124,645,479
2450,zielonystwor,1497,1683260,1124,486,638
59138,kakashisan,1577,1771539,1123,583,540
220,dabex88,1395,1563236,1120,642,478
486538,kamil2404,1217,1363156,1120,542,578
14021,umctomi,1374,1539460,1120,487,633
32020,benzer50,1299,1453058,1118,602,516
35714,miedzykolana,1397,1562422,1118,616,502
186886,kubek100,1667,1862239,1117,673,444
50018,marek0504,1446,1615971,1117,617,500
282621,nortonthetree,1346,1504282,1117,689,428
475487,cdc9503g,1452,1621475,1116,736,380
60255,gigawacek,1300,1451237,1116,510,606
50037,spartacl,1543,1722984,1116,417,699
2238,kali300,1365,1522543,1115,732,383
65931,misiek28,1184,1319855,1114,454,660
162927,tren1ng,1795,2000578,1114,689,425
14560,masakrrator,1423,1583135,1112,636,476
56918,ankafajna,1210,1344820,1111,496,615
213799,mrlukaszo,1502,1669469,1111,950,161
31883,dejna666,1425,1582531,1110,792,318
224,infinity322,1383,1535785,1110,546,564
9571,szejdas90,1373,1524183,1110,613,497
14613,ultima1991,1370,1520203,1109,455,654
69219,kmil94,1340,1484987,1108,567,541
483910,bst4060g,1484,1642225,1106,788,318
266669,wladcasmiecii,1463,1618672,1106,489,617
266810,ssuumm,1443,1593769,1104,567,537
325,grubas321,1399,1540857,1101,660,441
115745,duchlast97,1673,1838925,1099,609,490
103,arabek71,1459,1602359,1098,653,445
77488,alt,2016,2211925,1097,826,271
11856,solartec16,1244,1364770,1097,520,577
11290,kinmich,1354,1484118,1096,675,421
434216,cgf1707g,1421,1556333,1095,663,432
101546,n0wynick,2079,2274685,1094,697,397
618339,dryblerek,1624,1775117,1093,761,332
603678,marcinka22,1230,1345183,1093,469,624
1696,66kaj,1389,1515646,1091,634,457
30556,gwiezdnamucha,1449,1581373,1091,575,516
10221,maciex321,1305,1424807,1091,539,552
89079,czechu83,1221,1328988,1088,491,597
569099,przemo007,1324,1441062,1088,700,388
952,greg8310,1334,1449008,1086,622,464
234084,craghack,1343,1457418,1085,562,523
7025,moonlightbird,1389,1507611,1085,620,465
387312,dymek12,1488,1613561,1084,526,558
271155,virus1928,1459,1582540,1084,675,409
60882,galacticus22,1412,1529841,1083,630,453
86,bary83,1391,1504101,1081,668,413
41244,1989krzysiek,1385,1495324,1079,578,501
35970,agat1agat1,1345,1451461,1079,680,399
572415,benio4758,1380,1489884,1079,552,527
3063,kfkdrhals,1402,1513623,1079,606,473
529152,mjuniorek1982,1245,1344223,1079,571,508
112012,vlado1981,1225,1321499,1078,500,578
6061,artur0708t,1301,1402199,1077,510,567
1997,barcelona321,1420,1529624,1077,662,415
309105,ggb9100g,1246,1342797,1077,462,615
204850,zzabiurkator,1245,1341518,1077,488,589
13851,beneking,1585,1706106,1076,598,478
355379,tbw9562g,1448,1558814,1076,521,555
10960,chaos500,1286,1383349,1075,640,435
517990,fwf6801g,1360,1463028,1075,693,382
1894,razo,1392,1496642,1075,359,716
62355,graczfair,1369,1470663,1074,617,457
380330,trust,1610,1728016,1073,624,449
82987,milkaaak,1220,1308448,1072,474,598
569881,chester2444,1236,1323986,1071,524,547
222346,lamieparole,1484,1587386,1069,550,519
312574,szachexbis,1272,1360055,1069,564,505
10623,19agnieszka93,1188,1269200,1068,405,663
99390,izka111,1318,1407795,1068,583,485
77296,usuw,1534,1638497,1068,605,463
253889,zalecany,1757,1877239,1068,621,447
875,zodiaklew,1295,1383859,1068,517,551
14290,07jurand,1284,1370873,1067,527,540
26218,byczeoko,1427,1523023,1067,576,491
563516,kts6812,1260,1344807,1067,615,452
5138,zuziawr,1398,1491984,1067,612,455
81582,tadek78,1304,1390150,1066,591,475
63158,anonse,1468,1563741,1065,529,536
1915,damianj1115,1347,1433455,1064,455,609
1717,gminabudzuw,1601,1704496,1064,514,550
568821,blizniak1994,1309,1392079,1063,391,672
110715,mr0siekiera,1273,1353675,1063,544,519
514766,perfumwojcies,1488,1582268,1063,531,532
10306,pestek90,1491,1585391,1063,545,518
1185,jd36,1323,1405645,1062,518,544
610376,tbt1590g,1431,1520451,1062,617,445
149811,btb8659g,1184,1251357,1056,428,628
235607,bwk8455g,1379,1456737,1056,543,513
812,gabi82,1407,1485816,1056,590,466
4267,gumisiowasowa,1234,1303792,1056,488,568
492,raby11,1419,1498000,1055,589,466
58231,wojtas222,1343,1416926,1055,574,481
577043,fabcio,1269,1338315,1054,567,487
420369,break,1268,1335575,1053,448,605
911,cbs7984,1371,1443862,1053,547,506
88980,rayman1,1207,1271950,1053,446,607
58959,2minuty,1515,1594324,1052,455,597
653239,beznapinki,1413,1485488,1051,518,533
1789,nattallia11,1234,1297346,1051,424,627
111013,pawlszon11,1273,1337111,1050,498,552
94962,adamjp22,1319,1384328,1049,547,502
550542,blabla64,1398,1467425,1049,700,349
30155,rgw1910,1300,1364543,1049,583,466
48288,adrianfelek1,1392,1459059,1048,575,473
20546,kamillo9,1456,1522374,1045,546,499
13761,mciejaszek,1430,1494698,1045,550,495
70193,obywatel69,1312,1369929,1044,557,487
458141,adamato,1250,1304472,1043,461,582
20489,kurkanajajko6,1382,1442208,1043,491,552
529573,mpn861g,1362,1419515,1042,623,419
295091,addsa,1753,1823646,1040,639,401
137165,bambary3,1488,1548060,1040,454,586
138123,se6921,1318,1371755,1040,588,452
43637,jestempiernik,1320,1371498,1039,685,354
96156,mrkura,1318,1370315,1039,492,547
80918,marioboy88,1585,1645921,1038,615,423
5994,ffff123,1342,1392082,1037,454,583
148818,juleczka2098,1247,1292718,1036,580,456
88285,ksero022,1471,1523095,1035,512,523
255,turb0kozak,1727,1787722,1035,639,396
177245,panqbass,1391,1438393,1034,674,360
644,awajero90,1457,1502726,1031,553,478
88705,zeligowski,1414,1458797,1031,435,596
9058,martyna1993,1435,1478933,1030,486,544
610100,skaven1234,1315,1353491,1029,625,404
15029,stabiutki20,1912,1967916,1029,583,446
2457,sentymentalni,1819,1864498,1025,636,389
710,facecik15000,2006,2055051,1024,686,338
364320,p56prorok,1255,1286073,1024,536,488
27209,zioloo66,1510,1546258,1024,487,537
17127,danionho,1488,1523189,1023,443,580
120076,root,1542,1577616,1023,491,532
108397,bael,1673,1710521,1022,488,534
62725,koko122,1497,1530419,1022,573,449
57,qbens,1594,1629634,1022,671,351
115867,tina5,1216,1243489,1022,463,559
120927,8elpolako8,1340,1368375,1021,573,448
131065,stadion1,1304,1329287,1019,449,570
330312,wojtek1402,1386,1412407,1019,491,528
31930,0najlepszy1,1588,1617503,1018,598,420
52187,musicmar,1702,1733515,1018,588,430
189859,michaaalwwa,1337,1358413,1016,590,426
79844,f27,1329,1349274,1015,472,543
16571,pawcio222,1305,1324883,1015,600,415
6029,pagil,1163,1179743,1014,384,630
101232,proo100,1265,1281639,1013,473,540
92575,kotylek,1255,1269332,1011,402,609
222979,xdelis7,1580,1597418,1011,809,202
486,malawrozka3,1285,1298617,1010,553,457
36993,nakedchild,1444,1457301,1009,516,493
143629,profesorwor,1339,1351730,1009,429,580
370023,cgk6275,1209,1219425,1008,443,565
514577,dbp8994g,1399,1410207,1008,611,397
162913,fusko,1351,1362116,1008,539,469
387558,gnw7693g,1366,1374320,1006,581,425
3898,kooochamkinge,1369,1378060,1006,545,461
21210,lukaszwws,1092,1099158,1006,303,703
16214,polandc4,1484,1492096,1005,491,514
264812,djwhitenoise,1282,1287938,1004,530,474
61219,michaldinio1,1296,1301483,1004,540,464
260638,najgorszywto,1425,1431445,1004,506,498
50082,chronoz,1582,1587143,1003,750,253
113437,deessu,1769,1774769,1003,606,397
546139,kowal580,1496,1500895,1003,532,471
157,faptroll,1379,1382501,1002,393,609
145397,hakunamatak,1655,1658692,1002,535,467
164676,splack,1355,1358356,1002,476,526
245882,zepus,1875,1878751,1002,703,299
377972,bembenos,1317,1319020,1001,669,332
229381,centos,1581,1582899,1001,554,447
129136,chytryplan,1333,1335185,1001,487,514
378623,kilokoksu,1479,1479606,1000,587,413
525285,marcelproust1,1231,1231668,1000,440,560
2429,baka441,1422,1421412,999,589,410
5770,icecry,1556,1554995,999,492,507
12052,tppl1986,1424,1422759,999,631,368
193142,daniak88,1339,1336913,998,492,506
6192,kamild500,1401,1398947,998,494,504
20807,zajetaa,1286,1282891,997,560,437
699,beggi81,1444,1438862,996,733,263
215589,cfd9569g,1315,1309962,996,577,419
9713,jula7,1653,1647108,996,654,342
363745,neefreetete,1227,1222617,996,584,412
78214,rozkosznaasia,1325,1320155,996,400,596
297441,clawicl,2019,2009162,995,707,288
204837,gramwszkole,1815,1806172,995,646,349
98194,haluny,1742,1734276,995,633,362
215242,kuncioso,1459,1452551,995,553,442
236318,mikoyan69,1412,1404996,995,658,337
34826,anonim1133,1267,1259443,994,491,503
119827,leond88,1288,1279123,993,461,532
259090,truss,1396,1387145,993,637,356
609830,t1000pl,1257,1247176,992,412,580
85992,xwladcaswiata,1390,1379081,992,502,490
304900,0punisher0,1461,1448808,991,743,248
34825,bulczynska,1272,1261488,991,505,486
536688,kkp4433g,1402,1389886,991,639,352
399340,ivona00,1249,1237030,990,509,481
363746,klahadron,1164,1152732,990,412,578
605066,26011975,1240,1227242,989,473,516
971,rydzykzewsi,1687,1667714,988,766,222
150090,aplikant88,1449,1430704,987,651,336
70628,zdzichoowiertara,1435,1417040,987,483,504
280933,gotronk,1564,1542501,986,546,440
43935,gretzky,1382,1363472,986,455,531
494484,mgb2270g,1351,1330994,985,489,496
4931,pajak48,1594,1567444,983,771,212
1666,cienias10,1680,1650531,982,607,375
9654,lukmik49,1274,1252045,982,457,525
54388,cnp1598,1234,1210823,981,453,528
12276,fooooooooooooooo,1414,1387814,981,442,539
380003,jogabonito,1988,1948926,980,672,308
371322,lukaszlukas,1113,1091023,980,297,683
45390,mrgruchens,1365,1338010,980,514,466
178552,ledson123,1284,1256105,978,550,428
85559,sliwa12,1300,1271728,978,515,463
19320,zenekkrawczyk,1368,1338044,978,617,361
25222,filoner,1916,1872228,977,520,457
197724,adeptsztuki,1206,1177424,976,457,519
29337,pioter1992,1542,1505566,976,608,368
181455,poddajsiee,1348,1315722,976,532,444
392198,zjemcibabcie,1269,1238758,976,512,464
14211,zygnese,1644,1604848,976,505,471
1051,aomp,1378,1343551,975,544,431
8719,damianoron,1379,1345115,975,636,339
156658,sek4tor,1307,1274557,975,591,384
6553,alann78,1303,1269908,974,624,350
32482,dbct,1302,1269060,974,543,431
2936,masius,1284,1250830,974,432,542
191764,pmp598g,1584,1541578,973,661,312
475522,wff8274g,1347,1307485,970,545,425
211247,amonczito,1260,1221382,969,532,437
714,mych4,1485,1439206,969,620,349
583728,blak1988,1143,1107085,968,347,621
538424,hirus59,1296,1253631,967,471,496
614070,jerzuuuu,1402,1356486,967,601,366
35963,robaku44,1404,1357996,967,488,479
397731,batoniusz,1313,1269251,966,505,461
120,zizu007,1310,1265626,966,570,396
491692,mbt5666g,1382,1333774,965,598,367
329634,sfk1980g,1391,1342937,965,553,412
236,jancyki,1357,1309069,964,526,438
4105,7lech,1696,1634106,963,501,462
225030,zimen5,1494,1439603,963,477,486
251228,mahlojek,1559,1500156,962,510,452
48904,meziczka,1434,1379861,962,562,400
38157,transporter,1979,1902573,961,697,264
188495,wpd226g,1391,1337128,961,524,437
25002,cassver,1538,1476883,960,581,379
307850,edwin88,1253,1203516,960,553,407
329400,igi5000,1496,1436750,960,479,481
82079,qpaku,1754,1684595,960,623,337
2513,zjaranetopy,1985,1904229,959,670,289
5472,chovder,1549,1484529,958,476,482
193438,ddb7729g,1396,1338284,958,584,374
955,xylo,1593,1526233,958,565,393
45099,zielonajulka,1261,1208354,958,496,462
389096,banita78,1343,1285815,957,600,357
15470,smsbalucz,1632,1562635,957,547,410
3855,ragafaya,1431,1368549,956,489,467
74890,7cizu7,1369,1307768,955,529,426
72156,dfrtaja,1343,1282747,955,508,447
200808,pollukstroy,1413,1348249,954,507,447
53656,legiaaaa,1548,1475758,953,519,434
10123,rgb123,1494,1424674,953,435,518
87,alsgaard,1448,1378840,952,513,439
544035,bmf6549g,1298,1236379,952,538,414
33397,czupakabra76,1427,1358736,952,501,451
476956,kpw7088g,1369,1304135,952,543,409
134160,hcz2010,1552,1475160,950,526,424
7261,bwelegenda,1933,1835253,949,465,484
154,rafek75r,1327,1258325,948,450,498
350795,emdope16,1480,1401893,947,490,457
588824,gmb7993g,1165,1103995,947,353,594
145728,tomku,1612,1527322,947,605,342
546445,dgk9297g,1333,1261746,946,518,428
67651,kamilkas549,1058,1000626,945,277,668
556622,chanella1983,1134,1071418,944,341,603
146043,schematics,1671,1577812,944,400,544
514713,zerozerozeroz,1644,1550865,943,608,335
109855,derekwe,1910,1799336,942,523,419
272175,ftg6277g,1187,1119044,942,392,550
593338,laiczek,1846,1739134,942,567,375
141942,micbiels,1251,1179093,942,533,409
148705,bowjester,1365,1285066,941,403,538
37246,emarsolobis,1246,1171691,940,330,610
5983,pajmo,1403,1318993,940,424,516
130398,zealot6789,1274,1198280,940,396,544
120148,wseikrk,1274,1196698,939,485,454
13477,areknidzica,1196,1121931,938,450,488
526694,polpol1,1257,1179533,938,546,392
21553,panpilkarz,1250,1172064,937,468,469
13232,slodzik888,1273,1191569,936,531,405
3569,swx06,1351,1264730,936,561,375
156215,wsteczny,1332,1247561,936,486,450
49368,alson1111,1324,1238763,935,577,358
540256,mkm5909g,1093,1022779,935,320,615
13536,skutecznosc,1992,1862974,935,700,235
223157,dawid139,1304,1218152,934,455,479
332424,kapuccini,1201,1122337,934,371,563
250692,przemkq87,1280,1194240,933,526,407
38381,alkamil,1595,1486559,932,460,472
44067,elnarko,1641,1530288,932,534,398
1526,mac1965,1326,1236681,932,460,472
1689,jaques81,1358,1264752,931,477,454
5242,cynuus,1529,1422329,930,499,431
215519,datmeok,1208,1124157,930,400,530
162491,minavand0,1260,1171843,930,424,506
79540,rzeszow89,1405,1306825,930,484,446
8647,cortego,1530,1421947,929,454,475
1835,kolaj71,1225,1138794,929,356,573
85188,buc47,1877,1742361,928,632,296
498399,cpn4010g,1286,1193427,928,483,445
94829,kiciu,1288,1195599,928,326,602
286215,pozdrawiam93,1284,1191631,928,441,487
133797,matimaster25,1343,1244437,926,537,389
3644,jack1907,1381,1278059,925,453,472
362791,keeper12,1326,1227228,925,567,358
315007,sgn7439g,1400,1295194,925,487,438
633664,sobiash,1257,1162899,925,486,439
234,andaleopa,1322,1220364,923,412,511
1560,bob3903,1219,1125356,923,426,497
8730,sebster,1434,1324264,923,496,427
43132,brox27,1324,1220781,922,351,571
375413,ortel22,1275,1176262,922,455,467
303106,pawelnek,1311,1209183,922,380,542
279204,sbf8461g,1484,1368460,922,587,335
1392,rafalkq,1345,1237456,920,483,437
5153,anakonda34,1379,1268179,919,481,438
352735,laser096,1458,1340362,919,490,429
654954,luisnazarior9,1411,1296715,919,379,540
9877,rockooo,1956,1798083,919,488,431
539860,wtc3343g,1333,1225794,919,583,336
265885,huntervip,1578,1449302,918,511,407
126002,benekxyz,1399,1282997,917,441,476
514434,cgd3960g,1350,1238454,917,446,471
32331,mareczekboss,1285,1178837,917,379,538
84776,conc,1982,1813837,915,572,343
529462,psychot,1529,1398318,914,440,474
12357,awesomeman,1441,1316365,913,498,415
620427,dziewczynajeg,1341,1225170,913,515,398
483611,mgd4680g,1303,1190375,913,461,452
72147,b0dybangers,1850,1688025,912,523,389
264641,bcf4936g,1340,1222795,912,432,480
213103,kasiak1227,1445,1318687,912,578,334
390580,bwm6802g,1369,1247692,911,444,467
119929,maniek007wp,1576,1435980,911,449,462
48641,rysiuu,1369,1247834,911,546,365
141249,julietka25,1292,1175894,910,401,509
266,ksero123,1465,1332251,909,441,468
96338,zollo2009,1296,1178335,909,469,440
14617,mlodysokolek,1280,1162872,908,500,408
562925,pocisk762,1303,1183390,908,529,379
549552,wdg6961g,1309,1189017,908,497,411
3025,ratajesiu,1406,1275510,907,524,383
1084,sadzik1,1408,1277242,907,444,463
324923,kasia12kato,1554,1408313,906,491,415
455937,niemwdomnie,1301,1179300,906,559,347
591320,fmc3861,1236,1118829,905,378,527
174626,bolitar,1330,1202721,904,509,395
3203,kubczyk,1518,1372830,904,393,511
44824,nowicjusz30,1960,1772688,904,721,183
89464,prezerwatyvva,1457,1317959,904,441,463
622084,ronigda,1374,1242782,904,575,329
75591,kurczak198,1438,1299280,903,439,464
1990,repostok,1340,1210189,903,494,409
1455,blodas3,1477,1332337,902,445,457
44591,thewallbestia,1842,1661622,902,446,456
225913,gbm8361g,1312,1182159,901,594,307
56636,kastasquad,1488,1341169,901,499,402
477995,sgp7759g,1593,1435448,901,540,361
164694,territorr,1221,1100929,901,425,476
261800,paka1313,1332,1199130,900,502,398
364,senior116,1474,1327154,900,423,477
105270,508,1861,1673760,899,697,202
2034,abadon97,1555,1398753,899,508,391
1007,andrewq9109,1551,1394764,899,478,421
268034,gkk8600g,1342,1207156,899,515,384
595,socjopata95,1372,1233486,899,450,449
512370,m0rd0kl3jka,1229,1103717,898,451,447
477163,tps9976g,1574,1413656,898,418,480
216633,fns8811g,1366,1225368,897,529,368
20473,funiczek,1267,1137220,897,357,540
368,gryzcebule,1545,1386210,897,540,357
468522,jizzle,1573,1411858,897,426,471
47001,przem0,1345,1206517,897,553,344
168323,startin,1320,1184096,897,446,451
40466,kiwilinka,1268,1136501,896,527,369
34141,ndn8768,1305,1169666,896,536,360
135434,releks,1374,1229852,895,480,415
35515,nadolwba,1283,1147636,894,422,472
370918,perystaltyk,1432,1280255,894,388,506
137800,shydercaniemy,1425,1274643,894,381,513
32133,zkiw,1425,1274822,894,431,463
412780,21gram,1588,1418264,893,484,409
577526,dkg8325g,1341,1198021,893,470,423
76845,jjulkakulkaxd,1339,1195901,893,562,331
1177,stolarz996,1448,1293615,893,463,430
298230,adam456,1427,1273147,892,514,378
79593,cris1996,1246,1112192,892,371,521
347209,gfd7822,1199,1070224,892,399,493
72129,lordmanio,1445,1289132,892,451,441
331447,spark10,1486,1326381,892,430,462
60716,darkooo37,1233,1098945,891,484,407
150,7c6,1482,1319523,890,402,488
268903,nbw2411g,1327,1181091,890,495,395
226,achmeet,1494,1328295,889,333,556
8038,dacioo93,1441,1281363,889,483,406
92576,mamrotkaaa,1318,1171854,889,477,412
550816,andrzejuu,1369,1216051,888,442,446
308266,cbm5056g,1339,1189127,888,483,405
1474,kkk0turek,1597,1418157,888,451,437
372,ravau1,1445,1283931,888,514,374
80561,sessgracz,1484,1318622,888,504,384
564331,naknak,1283,1138317,887,454,433
5584,masywny,1348,1195001,886,437,449
45017,przegosc98,1273,1127439,885,386,499
2115,milutkamyszka,1274,1127086,884,286,598
120286,petrus2014,1350,1194052,884,446,438
95333,rudy1410,1381,1221142,884,529,355
187758,1marteczka,1256,1109169,883,424,459
453733,alumnus,1264,1116474,883,463,420
107852,korent,1274,1125604,883,395,488
228459,nmk5487g,1270,1121582,883,474,409
17589,2mk6,1395,1230816,882,499,383
384947,fpd8205g,1267,1118202,882,426,456
1576,arekj79,1399,1232974,881,371,510
4850,wjc5974,1263,1112953,881,537,344
4577,mhouse,1545,1359772,880,557,323
476460,bnf4384g,1590,1398193,879,493,386
646426,kgn2092g,1537,1351082,879,467,412
321527,niekryty,1716,1509099,879,485,394
666,huanitaa,1180,1036398,878,345,533
72172,zapobiegawczy,1857,1631197,878,544,334
489647,dotykschematu,1735,1521710,877,530,347
486376,int4r,1421,1247086,877,418,459
26163,tsp0,1344,1178880,877,428,449
97778,krokodyll3k,1395,1222717,876,558,318
450503,ressin76,1269,1112311,876,420,456
195033,kwazar1987,1597,1396535,874,430,444
559986,dkc614g,1323,1155294,873,394,479
69770,izba92,1600,1397039,873,491,382
376842,krasnalwp91,1352,1180852,873,389,484
1090,psych0l,1588,1387130,873,436,437
931,azerski5,1352,1179618,872,382,490
349585,ozorkow46,1299,1133320,872,500,372
72754,sylwusia04,1383,1206173,872,525,347
573993,cassii,1487,1295971,871,406,465
74077,emil1909,1363,1187535,871,490,381
196303,lewandosky,1559,1358390,871,545,326
435885,mariikii,1212,1054662,870,462,408
2887,oskarek99,1356,1179742,870,455,415
9945,wiktorek7919,1364,1186865,870,469,401
114518,jmaz29,1378,1196290,868,576,292
16146,lukasek22m,1356,1177478,868,499,369
344532,str445,1587,1377752,868,701,167
3542,ozibek,1553,1347314,867,404,463
291797,0510,1531,1325987,866,419,447
203291,krzysio117,1375,1191401,866,523,343
197082,mamuska22,1288,1115768,866,463,403
451695,twm4391g,1237,1071961,866,443,423
277,bejka66,1184,1024500,865,318,547
2829,kszykszy123,1522,1317343,865,395,470
244120,nefrati,1285,1111606,865,449,416
380027,marmit1,1299,1122873,864,426,438
94,czlowieksyrop,1337,1154648,863,471,392
117692,przegralesxdd,1415,1221738,863,553,310
474875,rysio63,1897,1637878,863,521,342
3189,szopenno,1574,1358407,863,559,304
32745,marek,1668,1438592,862,428,434
176784,twf606g,1384,1193222,862,518,344
25727,pomodoro,1443,1242658,861,513,348
278470,ssw9298g,1266,1090121,861,451,410
1294,kami876,1301,1119180,860,458,402
437227,tnw4247g,1448,1245860,860,491,369
302511,ksm722g,1218,1046652,859,377,482
1005,podagra79,1349,1159593,859,598,261
561175,adar24,1285,1102924,858,428,430
24364,roberth27,1304,1119313,858,410,448
245790,wojtaskurnik,1372,1177209,858,526,332
224427,wwk8004g,1457,1250219,858,413,445
509,tojatomasz,1372,1175961,857,379,478
53379,markus9,1352,1157583,856,376,480
99401,misiu0104,1243,1062000,854,459,395
319,dziuba30,1219,1040296,853,373,480
230711,oliwcia13,1251,1067828,853,394,459
147841,ryba9105,1425,1214543,852,400,452
357333,hydes,1647,1401674,851,513,338
572739,buleeeeek,1664,1414882,850,520,330
530650,ciqtytugraja,1508,1282434,850,420,430
445010,cmm1642g,1426,1212904,850,456,394
342280,malaamixd,1396,1186700,850,536,314
300055,nkm413g,1366,1161382,850,504,346
79671,lukaszxd96,1220,1036010,849,373,476
402878,mgw9798g,1402,1191012,849,567,282
9734,smoke777,1505,1278335,849,577,272
151844,davkom0,1323,1122600,848,407,441
410640,lukaseditt,1493,1266662,848,389,459
545021,martin667,1352,1145194,847,478,369
308219,straznikseksu,1477,1251478,847,492,355
475393,fdg8089g,1324,1120651,846,470,376
651818,dbogh,1474,1246051,845,471,374
246,sebasm88,1461,1235244,845,451,394
284810,eric0cartman,1441,1216688,844,477,367
464166,przemektavar,1306,1102513,844,498,346
2884,skalarrr,1252,1057249,844,437,407
2761,fedexkie,1422,1198944,843,487,356
5795,galileusz13,1300,1096363,843,412,431
575776,maxxxx,1413,1191242,843,413,430
16954,smove,1357,1144715,843,397,446
129766,brakav,1529,1287524,842,463,379
596672,dnn5205g,1250,1053328,842,419,423
192121,kukloczek,1232,1037450,842,377,465
351925,monochloropan,1376,1158721,842,541,301
13993,popkorn44,1291,1087745,842,393,449
382227,arcypurysta,2064,1736325,841,617,224
485,minikat,1946,1636860,841,584,257
143811,niunio,1319,1109589,841,544,297
94677,tomasz0097,1329,1117729,841,463,378
216068,nst2046g,1340,1124848,839,469,370
12105,xdsebaxd,1359,1141036,839,541,298
212682,87robert87,1254,1051208,838,386,452
59060,hannibal2323,1377,1154119,838,340,498
18054,mmmm555,1247,1045605,838,367,471
82901,darek2271,1327,1111411,837,523,314
567973,dpb877g,1359,1138243,837,383,454
2828,luis87,1461,1221510,836,633,203
119875,smerfiaki20,1691,1414491,836,416,420
46766,jotzpe,1462,1221194,835,456,379
80880,albinos1a7,1465,1222562,834,441,393
520876,gdw6517g,1254,1046364,834,406,428
1969,picczyniepic,1410,1176385,834,439,395
326,qwedsa20,1622,1353322,834,392,442
243153,fcflaschke0,1454,1211409,833,505,328
1285,paznokec,1313,1094021,833,439,394
162948,pgp3702g,1199,998829,833,378,455
202844,lachu1992,1310,1089987,832,461,371
161659,laniec,1224,1018605,832,226,606
152567,24grosze,1615,1342366,831,358,473
109733,aniamag,1336,1110923,831,367,464
397243,edzio0700,1239,1029788,831,439,392
79270,tornado21,1286,1069272,831,394,437
234887,trollinski,1457,1211064,831,495,336
66310,zdw,1710,1421470,831,421,410
85235,newcastleunited,1388,1152542,830,539,291
326018,fkd2493g,1257,1042551,829,460,369
4921,guciosuav,1348,1117551,829,458,371
117689,19kubus93,1268,1049931,828,384,444
186407,adik3313,1379,1142621,828,580,248
611261,jaca1988,1233,1021748,828,368,460
11608,jantar58,1376,1139891,828,512,316
436525,wfb8656g,1491,1234647,828,434,394
6260,wodniczek25,1254,1038962,828,460,368
40149,aanonim122,1236,1022290,827,347,480
14254,kamild122,1265,1046741,827,425,402
82149,lubieraczki,1291,1068253,827,495,332
70521,kakakgb1,1447,1195282,826,429,397
720,karel34,1503,1242180,826,464,362
621541,krasz,1465,1210874,826,439,387
1403,nela907,1353,1118358,826,496,330
60346,prz3mcio12,1274,1052399,826,415,411
124071,same0pasztety,1955,1615004,826,579,247
12968,kyri,1430,1180230,825,653,172
207986,mgd2669,1302,1074229,825,322,503
156373,mpc5018g,1384,1141879,825,516,309
424,wypite,1578,1302516,825,414,411
1951,1993pepe,1331,1097175,824,370,454
209839,mgn1706g,1417,1167789,824,425,399
37715,mwn885,1320,1087724,824,406,418
385584,ncg6967g,1329,1095532,824,497,327
2859,pvd90,1347,1110605,824,392,432
81360,masakra1000,1509,1242058,823,496,327
639164,mmg374g,1328,1093451,823,454,369
848,cocolin8,1460,1200555,822,472,350
362199,mixchal98,1884,1548784,822,535,287
89439,yungsimmie,1706,1402500,822,517,305
551474,fcp1923g,1399,1148667,821,460,361
249718,hosa20,1215,997932,821,362,459
1222,schabowy1991,1392,1143543,821,479,342
3459,szalek,1777,1459225,821,548,273
397235,alterzuk,1257,1030993,820,381,439
624219,jola55,1092,896112,820,253,567
35596,kurnikoland,2215,1816310,820,631,189
93350,lukai1,1267,1039274,820,430,390
93,mimoza2013,1277,1047539,820,426,394
10876,0jestemnowy0,1466,1200804,819,410,409
189510,dziewczyn12,1203,985580,819,357,462
545035,gtx,1583,1297134,819,433,386
180,pzilk,1421,1163949,819,432,387
475457,ttt6538g,1335,1094023,819,415,404
52448,damian203,1318,1078341,818,415,403
407644,yukki,1174,960852,818,370,448
4780,slawek0203,1342,1096616,817,357,460
1888,voxer1496,1349,1102815,817,426,391
4089,ic3m4n,1447,1181516,816,490,326
12664,kotar231,1254,1023607,816,436,380
162547,minutkacafee,1360,1110509,816,368,448
11176,west28,1454,1186987,816,410,406
339170,andres222,1591,1296756,815,657,158
1470,kubesq93,1734,1413812,815,572,243
342,zimny9393,1407,1147371,815,464,351
683,bella24,1363,1110058,814,480,334
136332,edukacj4,1441,1173562,814,558,256
1767,mainwola1,1462,1190631,814,415,399
453596,ms86,1349,1097082,813,423,390
239282,wdt2966,1299,1056772,813,509,304
1336,wirfek,1441,1172052,813,363,450
411203,bastek11,1419,1152393,812,563,249
7627,bazilav,1362,1106164,812,347,465
17862,goodmeen,1238,1005406,812,380,432
10169,kobra27,1505,1222336,812,497,315
183811,kucykp0ny,1424,1156725,812,366,446
100139,mimurek,1375,1116620,812,587,225
634834,muuuuuu,1385,1124871,812,339,473
87872,siuwaxs,1422,1155029,812,517,295
74768,sliwa1987r,1319,1071269,812,354,458
178988,wkibluwpracy,1298,1054321,812,414,398
83481,kytsan,1283,1039844,810,414,396
516676,matysenko,1403,1136550,810,498,312
96101,pbg,1956,1584499,810,449,361
124389,pfffail,1431,1159449,810,435,375
528567,rafalewy,1247,1010850,810,401,409
380648,cienias50,1254,1015272,809,470,339
17099,hegemon92,1452,1175138,809,340,469
34387,m6450,1501,1214917,809,542,267
21954,tomasz2506,1332,1078033,809,485,324
101486,808world,1804,1457871,808,614,194
39221,realmadryt10r,1286,1039187,808,307,501
614931,dtc8470g,1356,1094796,807,504,303
514815,dmb9862g,1492,1202738,806,522,284
1536,pawellos029,1282,1033619,806,410,396
30165,longer1,1181,950714,805,349,456
34696,albuz96,1345,1081733,804,446,358
336029,dracos210,1200,965063,804,349,455
538924,gpm9533g,1318,1059911,804,375,429
727,nevadiss,1263,1015956,804,361,443
475900,tkt2304g,1555,1250283,804,518,286
363939,pistolmike,1267,1016150,802,368,434
56432,robertgsxr,1550,1243423,802,453,349
634,seba2668,1358,1089218,802,444,358
475,shoxik89,1342,1076767,802,470,332
567556,michal7909,1381,1106631,801,565,236
486928,obnizamranki,1365,1094031,801,427,374
533878,grudru,1455,1164331,800,439,361
83260,kloaju,1326,1061133,800,462,338
14665,8pik,1263,1009307,799,341,458
221672,mon1kk,1410,1127139,799,421,378
363605,tcg5195g,1292,1032557,799,449,350
232946,tentypmess,1809,1445870,799,491,308
234651,gpm6725g,1194,953038,798,320,478
376516,djvisual87,1332,1061962,797,522,275
29871,fizol82,1934,1541635,797,462,335
251886,kwasakajoint,1427,1137948,797,465,332
408999,p1s4k,1394,1111202,797,403,394
426604,rav94,1330,1060514,797,447,350
475751,dbd6706g,1312,1044430,796,421,375
213084,wolnygti,1433,1141034,796,372,424
54302,chudy82,1351,1074730,795,359,436
1538,mastermarian,1320,1050008,795,446,349
8070,urokagnieszki,1963,1561027,795,407,388
84656,wujexen,1242,988125,795,358,437
298862,89mw89,1323,1051110,794,388,406
518753,elessar6,1183,939514,794,320,474
6397,stabiutki,1968,1563032,794,435,359
345096,dawpat00,1533,1214490,792,381,411
51615,kabaniarz,1260,998125,792,412,380
289337,skubbaniec,1421,1125845,792,355,437
110352,xevvil,1643,1301662,792,461,331
288899,tabaczy,1365,1080048,791,435,356
412392,thewinnerisme,1686,1333691,791,467,324
1817,lukaszqo,1469,1160710,790,359,431
10798,ttg9141,1222,965777,790,405,385
95171,meczet,1548,1221955,789,321,468
15295,miroo27,1427,1126135,789,594,195
414534,radiska,1477,1164536,788,480,308
113725,kamiryu,1227,965700,787,426,361
31401,carmageddon2,1259,989962,786,389,397
299335,kamilkstk,1371,1077911,786,371,415
226095,lighe,1299,1021094,786,427,359
84,chomiczowka85,1516,1190786,785,437,348
130054,diametralnie,1361,1068394,785,337,448
460977,gpk6480,1353,1062331,785,471,314
73628,kiki24,1264,992556,785,417,368
226573,modkurnika,1464,1149939,785,510,275
1318,orzech915,1435,1125812,784,475,309
200709,ugrampoma,1560,1223597,784,344,440
260964,mario9009,1248,977251,783,421,362
618367,bojlerwodny,1578,1234776,782,552,230
382471,dwf5056g,1284,1004119,782,440,342
1025,michalszo,1359,1062898,782,457,325
162465,petent69,1518,1186112,781,456,325
611154,rafix,1811,1414456,781,475,306
12751,zagramwczyscy,1668,1303457,781,438,343
58988,55xd,1692,1320316,780,418,362
73419,anetkaa13,1655,1291527,780,485,295
249549,bcddcb,1328,1036408,780,393,387
257513,kks4537g,1481,1155886,780,366,414
243843,ncg8688g,1329,1036901,780,421,359
475461,pfc7935g,1424,1111173,780,437,343
155599,tasiorrek,1222,953807,780,369,411
179076,tores67,1509,1177291,780,356,424
373119,1v1xd,1622,1263555,779,415,364
195536,gabek456,1465,1141999,779,599,180
79266,m123ateusz,1331,1037221,779,528,251
398639,ukaszch,1198,933421,779,360,419
514378,theuton,1435,1116629,778,464,314
23236,archie09,1267,984798,777,384,393
651876,janecki,1418,1102492,777,331,446
79462,paulina1851,1416,1100325,777,373,404
33551,zzzaqqqazzz,1276,992155,777,387,390
13809,elpawlo,1360,1055610,776,464,312
119,haary86,1375,1067498,776,429,347
46367,boniek99,1403,1087908,775,434,341
42740,demonsiodmy,1816,1407816,775,437,338
462584,gtr1,1456,1128618,775,467,308
265871,januszpilki,1458,1130592,775,430,345
69799,arsche,1232,952799,773,405,368
12271,kindgom,1487,1150087,773,480,293
44073,mateuszrtc,1416,1094844,773,387,386
32687,slaszer,1229,950639,773,385,388
16561,anttoonio,1473,1137877,772,443,329
97890,grigori27,1443,1114011,772,476,296
138158,interforever,1448,1118012,772,438,334
9421,lmsiwy,1294,999477,772,399,373
39068,mario380,1406,1085646,772,435,337
375829,oncwkssosna,1269,980298,772,370,402
401938,karbidka,1476,1138053,771,464,307
64179,adamsx29,1308,1007763,770,353,417
384504,dragon21luk,1546,1190850,770,393,377
20514,komo232,1162,895288,770,327,443
82791,libanczyk,1378,1061424,770,395,375
261090,sportagen,1436,1105852,770,391,379
456343,cubasa9,1511,1162540,769,450,319
407,lukaszr10,1430,1100366,769,342,427
400350,bubu99x,1287,989127,768,399,369
2267,ojer122,1328,1020311,768,395,373
3955,strumyk88,1612,1238672,768,355,413
136068,piescitomity,1427,1094534,767,352,415
329553,citizens,1719,1317025,766,492,274
4266,niegramdobrze,1868,1431596,766,407,359
747,tigergut,1285,984857,766,372,394
66284,rambocop,1335,1021780,765,443,322
1579,supers71,1299,994212,765,379,386
386210,elmarianow,1255,959487,764,410,354
132755,mariuszwp,1588,1213442,764,388,376
561701,pct1447,1412,1078790,764,408,356
133480,2642,1464,1117091,763,357,406
51583,erto71,1251,955031,763,361,402
284878,makar334,1543,1177688,763,562,201
21750,sys3k,1229,938188,763,428,335
26069,efod,1284,978751,762,327,435
2563,kan0,2043,1556930,762,501,261
585144,pmf9050g,1303,993353,762,475,287
18908,ravenwolf,1549,1180726,762,403,359
6169,enterus,1679,1277828,761,472,289
52136,kleszczoslaw,1260,958958,761,364,397
142837,szyszakk,1369,1042351,761,363,398
893,nordberg,1604,1219675,760,463,297
514961,pbw573g,1401,1065108,760,440,320
1690,czarnooo,1245,945538,759,322,437
447497,gmd8773g,1266,960928,759,364,395
89072,levi1916,1294,982429,759,400,359
188621,rybson84,1317,999606,759,429,330
86847,stoomek,1283,974062,759,293,466
378732,anka14472,1440,1091533,758,362,396
235629,blazej28,1237,937825,758,344,414
23824,grzesiek010,1227,930348,758,361,397
79398,hopy,1234,935828,758,379,379
77150,kasiara1982,1346,1020483,758,442,316
543558,moriss1,1562,1184268,758,570,188
486347,wfk8227g,1257,952927,758,352,406
303670,amig69,1382,1046793,757,479,278
91071,cacek5,1186,898471,757,306,451
103949,ceskytesin,1611,1220187,757,330,427
21222,emeszenes,1431,1083401,757,507,250
130611,ewa87m,1256,950989,757,388,369
223674,hidaalgo,1349,1021929,757,353,404
175698,sosnowiczanin,1623,1229155,757,354,403
168859,direx94,1265,956551,756,371,385
74494,playforfame,1744,1319182,756,466,290
217324,ppic,1803,1363249,756,570,186
106751,fraglo1,1260,951705,755,414,341
9225,krzysdsd,1300,982177,755,450,305
5040,aljas,1440,1086000,754,332,422
2771,bangi111,1378,1039672,754,376,378
29993,deanrev,1417,1069005,754,247,507
132168,belus0773,1247,938170,752,410,342
48271,pozar998,1260,947594,752,358,394
350883,thegame1321,1264,950663,752,416,336
136955,uiopzxcv,1278,961317,752,391,361
8464,satyr379,1462,1098573,751,426,325
613108,bgw4810g,1322,992228,750,452,298
367232,chloe2016,1341,1006498,750,461,289
175746,jewgienu,1699,1274452,750,374,376
43334,1988aneczka,1196,895952,749,328,421
1818,cukierekzkwasem,1423,1066409,749,456,293
266368,ja69,1492,1117604,749,429,320
466700,puug,1411,1057178,749,331,418
19109,carlos2311,1272,952159,748,356,392
23058,88kasiek,1365,1019820,747,391,356
121477,zaiku,1556,1163075,747,398,349
105982,bratkoru,1392,1039068,746,474,272
27267,childegarda,1355,1011559,746,504,242
180128,fwt9869g,1214,905695,746,349,397
10627,kamilloossss,1593,1189045,746,422,324
556546,tkm2364g,1326,989362,746,391,355
76155,arkadiuszman7,1350,1005764,745,430,315
601955,dns6492g,1260,939130,745,352,393
91145,kukivip,1270,946265,745,349,396
354507,mwb9262g,1490,1110378,745,497,248
439397,stumbras,1358,1012070,745,492,253
44655,thoddes,1369,1020241,745,383,362
28097,barcateam,1492,1110513,744,368,376
35159,bbaron,1316,979807,744,356,388
384757,gcf8925g,1289,959497,744,401,343
1425,trzempion,1394,1037388,744,315,429
47811,bestiaxef,1658,1232402,743,384,359
166,94michal94,1426,1058224,742,499,243
186501,blackolive,1239,919369,742,359,383
525510,bossman25,1316,976865,742,435,307
33834,latrunculus,1447,1074175,742,398,344
10566,miknzr,1306,969373,742,441,301
37701,przemsong,1380,1024503,742,343,399
574104,redzik1,1464,1086944,742,380,362
32978,skorzany85,1278,949017,742,355,387
124408,cichyziom,1408,1044056,741,321,420
203217,dager11,1290,956022,741,410,331
52476,darecki100072,1384,1026031,741,475,266
38658,tnt87,1406,1042173,741,254,487
1642,xcsxcfzxbdfg,1485,1100941,741,316,425
247337,arwoj,1324,979783,740,422,318
6264,cij,1394,1031931,740,441,299
259350,jarozxc,1371,1014711,740,388,352
184923,yopo,1495,1106770,740,395,345
447928,endiendi,1259,930709,739,283,456
75273,pudlomistrz,1734,1281800,739,488,251
9247,kmiotek,1443,1064977,738,397,341
292621,marsawelblag,1350,996447,738,373,365
78762,migol123,1485,1095964,738,553,185
88227,nnkknn,1271,938405,738,414,324
37,shinl0ck,1650,1218090,738,468,270
1443,stonka321,1266,935010,738,360,378
436261,tpc9692,1181,872282,738,340,398
649,tamtol,1406,1036802,737,501,236
560675,knc1789g,1660,1221914,736,468,268
8351,kufus27,1201,884360,736,385,351
428,passo21,1389,1022922,736,473,263
172300,frassinetti,1295,952023,735,413,322
5127,rafeq,1820,1337968,735,480,255
475471,nbd8700g,1162,853105,734,247,487
103588,kasiaran,1197,877742,733,364,369
103587,krzystorun,1202,881458,733,369,364
41199,patrykass,1439,1054797,733,482,251
101030,przystojniak7,1317,965877,733,385,348
341851,truskawezcka,1273,933687,733,362,371
47859,87rafalski,1355,991895,732,382,350
39581,kalexa,1295,948460,732,456,276
1101,seni0r24,1293,946846,732,433,299
274544,barrabravas2,1487,1087578,731,405,326
285463,fpg7597g,1603,1171814,731,345,386
1981,knutek8,1379,1007245,730,350,380
1164,krzysiekp89,1240,905920,730,408,322
1578,visconti,1445,1055095,730,426,304
530770,wmb7133g,1393,1017538,730,433,297
135255,nickdlapopisu,1636,1192761,729,380,349
2672,sysia1474,1790,1305534,729,435,294
7186,barbroo0ther,1638,1191122,727,456,271
3770,diablero,1814,1318785,727,395,332
6248,nerazzurri11,1340,973319,726,342,384
461401,pijepiwka,1598,1160738,726,406,320
57865,kinkos,1367,991191,725,420,305
111574,mclech,1508,1093474,725,338,387
14671,osob,1540,1117072,725,435,290
507,jopeksenior,1288,932574,724,378,346
205617,kpt8924g,1281,928038,724,367,357
1100,niezek,1391,1007149,724,431,293
2001,prestize,1424,1031473,724,343,381
187028,zagrajmysobi3,1575,1140825,724,375,349
119537,nulikon23,1629,1178477,723,582,141
89,pitevo,1704,1232627,723,349,374
1549,rooster2012,1469,1062408,723,405,318
351105,rosiu42,1431,1035246,723,563,160
258450,bobrasmyraj,1374,992156,722,403,319
625507,dziadzia90,1361,981666,721,415,306
4376,lamka673,1588,1144979,721,362,359
476576,mcm477g,1305,941312,721,437,284
72750,rzucam6,1674,1207169,721,381,340
144120,signify,1840,1327324,721,430,291
102821,smarki2015,1280,922899,721,389,332
370701,dkc7818g,1478,1064184,720,486,234
576116,houseofgames,1424,1025744,720,436,284
108138,jestemjulkaxd,1356,976548,720,427,293
598215,ssk5592g,1407,1013349,720,555,165
116836,zabobons,1451,1044883,720,417,303
381433,samsam1,1465,1053637,719,363,356
26207,saquas,1502,1079980,719,366,353
290338,11grzegorz11,1328,953704,718,488,230
152,alanik123,1326,952522,718,406,312
197751,ewunia17,1296,930778,718,333,385
386211,jagielekwarka,1231,883966,718,339,379
125780,przemocowy,1255,901553,718,347,371
362817,bloodymoon,1584,1135943,717,377,340
53518,dawideeek,1551,1112146,717,419,298
486475,fk00przegrany,1380,990008,717,413,304
439887,drhouse,1869,1338342,716,444,272
487564,mwm2614g,1354,970128,716,353,363
140674,regular,1643,1176906,716,421,295
424125,fr33styl3r,1523,1089384,715,342,373
12234,undertakerr,1548,1106916,715,403,312
301550,wilku1212,1281,916304,715,439,276
48320,zieloneg0wno,1732,1239032,715,414,301
164193,samsim,1258,898915,714,354,360
15274,agm99,1325,945362,713,342,371
32877,cechu13,1424,1015828,713,345,368
361934,epick0,1738,1239326,713,440,273
15700,hymir,1594,1137145,713,378,335
24518,jaciealegacie,1744,1244025,713,351,362
243545,k0rnik,1534,1093880,713,388,325
418380,btg6051g,1288,917712,712,426,286
241208,fastball,1546,1099551,711,343,368
261313,kcem,1448,1030149,711,362,349
69190,marcur,1321,939586,711,384,327
114305,mariuszek87,1436,1021545,711,340,371
556052,mathewgw,1303,926845,711,401,310
1444,wiolesz,1294,920477,711,339,372
514371,wtn5905g,1395,992534,711,394,317
579241,adrianf03,1359,965160,710,329,381
483669,bws1097g,1296,920714,710,394,316
34096,qbaniec2,1372,974726,710,470,240
51680,roomann,1313,932756,710,434,276
507688,gensheimer,1458,1034345,709,447,262
608868,neeexx,1441,1022074,709,354,355
45653,otwieraczz,1209,857226,709,320,389
27573,wiktor1981,1330,943193,709,420,289
48915,cinek1357,1368,967653,707,347,360
26582,dan37iel,1274,900784,707,306,401
1754,fanns88,1200,848942,707,367,340
62653,madzia1712,1243,879410,707,341,366
236528,najs,1453,1027955,707,352,355
31065,sromwgacie,1936,1368794,707,331,376
235,sylweo,1316,930780,707,380,327
131089,4motion,1505,1062850,706,388,318
2168,bartek392,1320,932299,706,324,382
134376,beona,1425,1006158,706,330,376
5379,konskipaczek,1442,1018311,706,396,310
68107,thepanacea,1260,889856,706,338,368
2039,777tomek,1425,1005152,705,435,270
427968,agunia0510,1226,864892,705,290,415
64564,beet19,1436,1012603,705,377,328
84958,dopszeee,1305,920397,705,362,343
187579,hienes69,1417,999574,705,463,242
3772,xdc,1634,1152228,705,413,292
470330,kochamadeb,1268,893278,704,313,391
74416,konioslaw,1450,1021293,704,325,379
348931,rozpusta69,1363,960225,704,339,365
629563,swg1821g,1226,863410,704,341,363
49173,astrajos,1512,1063055,703,379,324
625588,serb1,1235,868554,703,321,382
111562,sexymis,1310,921110,703,418,285
57397,caramba13,1298,911746,702,388,314
5973,magnum2010,1321,927425,702,327,375
3097,mati1098,1494,1049355,702,429,273
77182,mechanik4,1263,887050,702,340,362
101226,polaczekvip,1285,902411,702,368,334
231662,sebello,1302,913335,701,420,281
88575,xerossa,1399,981367,701,368,333
296201,134,1430,1001598,700,384,316
52653,biniol1,1324,927381,700,385,315
567047,pdm7087g,1647,1153047,700,448,252
57773,witch98,1290,903677,700,366,334
397941,8maku6,1257,879087,699,390,309
625832,dcw6366g,1211,847127,699,348,351
305064,pom0,1525,1066288,699,425,274
38099,cwiczesobie,1816,1267658,698,386,312
334766,czek0tubka,1136,793326,698,233,465
1266,arturjabol77,1424,992729,697,371,326
352889,ili,1387,966773,697,376,321
30320,koviet,1397,973969,697,410,287
42075,pleace,1593,1110883,697,409,288
105241,prq,2012,1403009,697,475,222
15605,dajdajpompke,1289,897305,696,290,406
473423,joeblack84,1431,994876,695,382,313
3614,gutek1982,1251,868851,694,359,335
33124,ndmaverick02,1376,955231,694,373,321
1537,piachu17,1453,1008789,694,444,250
272000,rud0brody,1734,1203753,694,422,272
440141,struzes21,1291,896568,694,321,373
16674,tomekbeblot,1328,921674,694,374,320
84405,wojtasos96,1278,887297,694,425,269
389287,kornelia123,1283,889396,693,421,272
442374,mnt9133g,1357,940689,693,361,332
617579,fcd3349g,1475,1020801,692,427,265
60832,oli171,1213,839580,692,345,347
48766,oreotg,1406,973301,692,345,347
464260,oshiro,1275,882882,692,383,309
108619,req8,1283,888030,692,351,341
8175,sz1234,1315,910174,692,322,370
582538,danzell,1398,966119,691,401,290
150773,gpf3328g,1442,996467,691,389,302
222240,pfn4382g,1445,998578,691,373,318
155192,roy06,1400,967766,691,458,233
263100,shamtu71,1263,873137,691,360,331
147389,kpg2764g,1368,944084,690,404,286
263,longi123,1432,988350,690,487,203
159939,40letnitetryk,1282,883834,689,387,302
1837,addaam15,1282,883746,689,295,394
27790,drdre38,1482,1021440,689,463,226
8848,kuba6671,1276,879463,689,309,380
780,77best77,1482,1020198,688,292,396
24024,jelen12,1232,847816,688,356,332
94510,leaiver,1743,1199301,688,351,337
382608,pankanapczak,1348,927504,688,416,272
61,boggy23,1404,964653,687,480,207
162,dearc,1266,869763,687,280,407
532453,synttaxerror,1462,1004941,687,352,335
406302,ttt82,1251,860051,687,382,305
61475,waszbret,1525,1047926,687,417,270
2867,miz28,1303,894216,686,327,359
77406,arkadiusz2015,1265,866925,685,362,323
804,interhanys,1613,1105578,685,378,307
69992,pudzias,1364,934513,685,280,405
406081,renia151525,1256,860477,685,356,329
111955,ventor88,1272,871895,685,341,344
262749,12tnera,1448,990916,684,388,296
300946,atoyamo,1272,870588,684,429,255
242,nowy94,1377,941939,684,366,318
197098,robento,1258,860508,684,330,354
90763,ewiq1,1528,1044058,683,366,317
74431,alhatal,1349,920198,682,317,365
284270,ccd2685g,1424,971530,682,382,300
112833,kgbdawid,1988,1355944,682,472,210
825,sylwek997,1380,941638,682,390,292
520981,woblerek,1381,942218,682,360,322
112253,ciemnymrok93,1535,1045787,681,494,187
16406,josemariaguti,1967,1339717,681,431,250
39297,skrytobojca,2125,1447712,681,541,140
358386,spc5053,1370,933143,681,379,302
278349,kupastefanka,1335,908471,680,358,322
424984,nurmengard,1595,1084600,680,368,312
473127,schirin,1322,899413,680,381,299
5599,nexeil,1265,859449,679,290,389
3625,cogliostro,1393,945051,678,407,271
438637,kingragnarpl,1506,1021576,678,428,250
425,ojedidiah,1562,1059645,678,358,320
6428,respectrulez,1523,1032778,678,329,349
536243,soolla,1185,803611,678,290,388
39504,gipsdeka,1531,1036521,677,411,266
540485,pawel2406,1184,802135,677,270,407
243876,pzaauj,1305,883682,677,382,295
190967,slawek2045,1218,824671,677,323,354
2689,wookiecookie,1501,1016820,677,363,314
3174,1nicniemusze1,1551,1048868,676,374,302
155059,asialat7,1565,1058609,676,554,122
554431,bsf8667g,1410,953223,676,380,296
5288,crn11,1367,924413,676,363,313
26895,edytkab13,1580,1068295,676,342,334
206425,mati1237,1343,908121,676,341,335
171601,robinho9,1226,828858,676,319,357
211248,ulfisko,1184,801026,676,270,406
46676,waterresist81,1197,809558,676,255,421
315054,ar166,1327,895866,675,291,384
566887,gnc4528g,1779,1201280,675,426,249
153646,klops01,1275,861012,675,366,309
125725,ee3,1423,959250,674,659,15
126959,monika115,1358,915408,674,381,293
16323,szpaczek1245,1526,1028612,674,399,275
48089,bialy0,1419,955176,673,390,283
12712,guciox777,1482,997591,673,369,304
334271,rpatezgra,1580,1063625,673,398,275
50161,toma6673,1545,1040011,673,391,282
325576,yuuui,1349,907915,673,313,360
318,david1250,1413,950097,672,519,153
231161,kubunia1989,1175,790107,672,268,404
270660,marla987,1346,904712,672,378,294
254493,tct881,1165,782921,672,313,359
307005,wcb1709g,1237,831491,672,370,302
407661,wujekr,1373,922825,672,376,296
14969,todomeda,1809,1214330,671,269,402
7875,sssmarcjansss,1381,925273,670,322,348
4292,szczurek155,1330,891706,670,273,397
28748,20607krystian,1360,910376,669,391,278
29663,fhupawa,1376,920571,669,346,323
9989,henry86i,1380,923248,669,335,334
43593,ja1609,1333,892072,669,324,345
38665,prowokacyjnie,1566,1047961,669,580,89
50446,arek4,1381,922937,668,325,343
558771,domino22,1387,926600,668,299,369
534101,fnp4329g,1246,832810,668,341,327
274474,jurand19,1346,899687,668,437,231
5607,solarfield,1488,994193,668,328,340
215245,tequilaa,1489,995127,668,371,297
509933,0ptimus,1519,1013712,667,383,284
2722,konstanty10,1351,901613,667,327,340
245968,jesteszawolny,1494,995449,666,323,343
22451,kubaa95,1413,941383,666,387,279
26164,wjw10,1333,888308,666,380,286
1580,dorciadoris,1285,854853,665,324,341
244812,bedzinwarpie,1494,992354,664,365,299
12411,rylomen2,1217,808715,664,274,390
5155,akinomonika,1397,926774,663,435,228
6186,marcinzzmc,1340,888728,663,316,347
260935,barca28,1320,874127,662,310,352
187878,cdw1645g,1526,1010553,662,494,168
628,fordziak,1330,880918,662,418,244
1437,lukasz2790,1350,894315,662,425,237
9180,kamilmalek222,1407,930445,661,334,327
509837,kuerwes,1692,1118475,661,322,339
7605,29stupsk09,1233,814279,660,265,395
569656,dominika2701,1203,794415,660,325,335
290056,ja3kub,1340,884432,660,383,277
21514,kuubaa123,1274,840961,660,329,331
824,milenkagra,1341,885509,660,374,286
442971,radmatu,1226,809526,660,329,331
158346,swiiirek,1188,784252,660,229,431
1938,boehmi,1266,834951,659,326,333
11198,josedelawega,1218,803111,659,277,382
327091,mwc9084,1269,836370,659,340,319
304265,bgm840g,1229,808828,658,356,302
1219,rawcio123,1294,851489,658,355,303
23595,snajper1993,1318,867480,658,407,251
508451,wodazbutelki,1460,961042,658,408,250
227170,slawinka,1224,804518,657,355,302
436301,wtf3403g,1473,968038,657,350,307
1079,chemikc2h5oh,1287,844646,656,238,418
9075,llloottt,1584,1039731,656,318,338
5531,tomcio1044,1398,917702,656,388,268
575094,cds1820g,1251,819814,655,362,293
218957,pogodny26,1362,892390,655,366,289
403256,polychem,1337,875937,655,334,321
1954,doctoree,1496,978393,654,356,298
337740,kasia13krk,1525,997481,654,317,337
343482,seensii,1278,836105,654,329,325
226548,gramjakpipka,1469,959596,653,294,359
507192,hajdujudu,1329,868457,653,390,263
98812,knefel93,1370,894632,653,339,314
28578,lek19,1512,987467,653,345,308
393482,monikqax,1242,811664,653,350,303
76256,plturkusowy,1177,768971,653,256,397
14092,biauy,1785,1164140,652,327,325
163878,fbf4507g,1287,839537,652,329,323
17880,idol801,1332,868911,652,387,265
147408,ssd6058,1464,954754,652,435,217
193251,19800501,1197,779380,651,290,361
574049,bcc5757g,1243,809251,651,333,318
186861,chybasniszej,1427,929585,651,353,298
49672,suspensywnosc,1535,999321,651,343,308
251617,mmmig69,1428,928714,650,455,195
18055,paul125wrc,1563,1016239,650,395,255
400058,poigramy,1224,796152,650,291,359
200543,poteznygimbus,1532,996175,650,381,269
227969,damianos114,1333,865428,649,414,235
269495,fmb178g,1245,808221,649,327,322
65054,kill3r,1224,794964,649,328,321
137754,kubix45,1313,852356,649,321,328
223337,lukikiler,1243,806984,649,314,335
36955,michaljurek25,1347,874763,649,356,293
297462,dokon,1280,829877,648,349,299
1640,patryk1704,1252,811619,648,323,325
233011,rewanzmoze,1684,1091837,648,328,320
76046,sonic1239,1351,875778,648,349,299
558289,swiezak33,1352,876401,648,429,219
20436,vanope,1299,842363,648,430,218
4654,henry310,1293,836626,647,348,299
213628,wilgotnaaa,1428,924078,647,392,255
235943,andrzejk87,1364,881761,646,336,310
188684,dareklew1969,1261,815044,646,357,289
84241,enthusiasm,1888,1219649,646,359,287
66947,k2swirus,1288,832201,646,405,241
107080,uuj,1605,1037243,646,402,244
44383,rafalabc,1114,718785,645,233,412
254492,krolewnakasia,1188,765353,644,339,305
557092,panzbych,1289,830210,644,328,316
221,pvssydoll,1313,845851,644,298,346
184033,sfb9333g,1354,871979,644,323,321
65368,szymcioo24,1270,818429,644,299,345
86164,kakakgb,1449,931836,643,304,339
555,mikul81,1364,877384,643,350,293
183506,szukamklanu,1930,1241493,643,346,297
183411,vmiqez,1408,905364,643,409,234
897,1mowmiadi1,1300,835211,642,280,362
589240,fgc6632g,1425,915005,642,319,323
563273,natelefon,1825,1171857,642,392,250
13474,ripovsky,1336,857839,642,349,293
401881,wpc6911g,1404,901494,642,364,278
469721,9luisnazario9,1415,907385,641,287,354
22563,pawel1m1,1298,832107,641,379,262
38924,zuzia8153,1668,1069512,641,375,266
102794,checknew,1461,935345,640,321,319
3386,kacpirq,1280,819516,640,325,315
248879,nmb4892g,1440,922239,640,373,267
19164,studzian,1770,1133329,640,379,261
609200,fiftu,1660,1061201,639,464,175
594047,dfb6325g,1379,880091,638,323,315
347747,ffn7515g,1424,909089,638,367,271
32456,xraulx,1591,1015486,638,326,312
249819,fkd9352g,1476,940540,637,291,346
17679,kototok,1438,916370,637,419,218
106402,wojtekss11,1518,967555,637,439,198
347832,nevadasmith,1246,792928,636,303,333
543561,nmg3692g,1587,1009772,636,446,190
117700,axavo,1234,784128,635,295,340
200099,dns9098g,1263,802153,635,340,295
13262,kebe21,1343,853240,635,319,316
541671,zuzia2601,1253,796207,635,320,315
166072,gz83,1464,928738,634,511,123
15404,czerwo93,1225,775516,633,324,309
4579,jehoszua,1351,855186,633,445,188
327449,sebo228,1164,737168,633,264,369
3777,mronkiewicz,1404,887680,632,291,341
256423,pasta2008,1266,800166,632,315,317
34291,grze13,1495,943575,631,358,273
13960,kuba333,1505,950017,631,322,309
168070,mikodai,1263,797189,631,272,359
73592,onarobidolamu,1386,874710,631,306,325
94200,piottr610,1356,856055,631,322,309
9377,strelicja261,1187,749477,631,263,368
21836,szotrabik,1368,863542,631,299,332
214510,bibliotekarz,1362,858633,630,350,280
687,wirujacylolek,1382,871038,630,331,299
86032,zoneunknown,1871,1178734,630,330,300
52118,batman3333,1317,828698,629,374,255
247287,gguma,1309,823496,629,362,267
42690,onomale,1337,841185,629,383,246
613062,abukabuk,1264,794192,628,305,323
8113,hitemup,1612,1012411,628,342,286
35562,tedmu,1543,969175,628,318,310
143296,wmn8417g,1382,868415,628,382,246
579850,wru9,1195,750608,628,236,392
502026,dsk6183g,1692,1061080,627,392,235
103086,ihaaaaaaa,1429,896419,627,305,322
41533,xtunerx,1309,820945,627,262,365
602072,maxms,1401,877572,626,278,348
405093,nbd7650g,1516,949616,626,264,362
548654,poncek,1331,833237,626,376,250
17575,adrian1620x,1359,849499,625,331,294
607139,kemto3333,1242,776745,625,304,321
20857,sinyapacz,1242,776773,625,309,316
88468,wrzodnadup,1362,851542,625,376,249
51595,bobek987,1337,834445,624,325,299
360539,dkk5304g,1256,784253,624,297,327
525947,guciikokot,1551,968150,624,336,288
374593,mikko2,1411,880566,624,362,262
361227,mondeo09,1364,851484,624,273,351
378027,ngj757,1256,784167,624,283,341
573095,artur2199,1389,865624,623,351,272
116296,carpediem2,1307,814508,623,337,286
68969,lena108,1314,818807,623,376,247
439301,ocobiega,1284,800455,623,305,318
708,zenek258,1236,770029,623,290,333
11312,dagusia2886,1475,917837,622,369,253
1602,deathis,1411,878154,622,390,232
532730,hyga,1646,1024359,622,385,237
134320,magda103,1193,742419,622,254,368
266110,wezme12,1309,814743,622,291,331
2979,alangracjan,1442,895746,621,278,343
68323,edo16,1379,856543,621,316,305
74448,okocza22,1187,737388,621,281,340
468,cinioo,2036,1262738,620,393,227
29775,sylvia4283,1244,771843,620,279,341
97201,wudztegapala,1346,834733,620,350,270
171946,fbn,1496,926385,619,409,210
143133,thefazi,1188,735917,619,291,328
367813,marcine1989,1326,819828,618,338,280
515468,ndw2101g,1423,880008,618,411,207
152618,ryceszczeslaw,1371,847791,618,353,265
78784,strasznywilk,1544,954400,618,314,304
497890,themykacz,1693,1046637,618,334,284
185208,tmn2356,1251,773378,618,344,274
76552,tosiaab,1451,896742,618,345,273
493167,zzuukk,1324,818667,618,335,283
393004,blacklion1991,1511,932466,617,395,222
127618,mmmmmmmmmmmwmmmm,1996,1232142,617,505,112
104608,krysiak1,1285,791831,616,372,244
3790,cienki20,1955,1202725,615,301,314
160204,daniel32,1263,776932,615,373,242
28324,kiepak,1386,852612,615,308,307
173435,wkb478g,1272,782704,615,322,293
276,berusia,1309,803980,614,331,283
500507,mpt8564g,1349,828751,614,352,262
648535,ncf4793g,1238,760176,614,276,338
348254,tsubasaozoraa,1461,897544,614,326,288
199586,biznesmen3,1313,805477,613,373,240
46833,ekspertos17,1348,826527,613,360,253
1414,judyta0128,1455,892066,613,368,245
256,mejdej172,1277,783249,613,340,273
137646,rysiekbobik,1292,792175,613,376,237
87744,doprzodu91,1357,830956,612,255,357
154724,eemilka200,1412,864623,612,351,261
173908,rebel2306,1239,758343,612,348,264
33141,streight84,1302,797026,612,329,283
1980,zbych75,1416,867002,612,268,344
358389,bluuumka,1243,759821,611,342,269
559482,lidka123u,1219,744923,611,298,313
238593,patryczek2003,1401,856020,611,284,327
172546,zaroklyt,1421,868438,611,356,255
2323,aga14klaudia5,1406,857709,610,310,300
363428,mordeczka87,1309,799081,610,357,253
21348,strazak39,1230,750775,610,302,308
4697,knabo,1324,806848,609,314,295
213957,kudlaty90,1283,781566,609,308,301
34691,martinson,1477,899712,609,287,322
541147,drackkula,1447,880316,608,318,290
463053,golakolgol,1434,872092,608,301,307
801,marek19,1304,793379,608,272,336
173459,czescgrajmy,1423,864315,607,235,372
186282,dami1310,1274,773757,607,325,282
22612,gelov97,1458,885139,607,408,199
287175,kfw2772g,1371,832535,607,334,273
128154,maciej156,1306,793271,607,355,252
103246,maik444,1330,807656,607,388,219
255247,swp8218g,1182,717963,607,241,366
195981,tts975g,1486,902283,607,321,286
37119,walos,1462,887589,607,349,258
10741,xxsuperboyxx,1441,874870,607,346,261
3588,adaka212,1199,727086,606,228,378
61200,cichyyy,1583,959563,606,375,231
28749,garson118,1204,729858,606,278,328
17619,puhatek69,1419,860074,606,366,240
36747,allworld,2159,1306792,605,369,236
1307,dziekujemy,1433,866977,605,337,268
307,ilonamelia,1221,738724,605,286,319
135390,tbm5613,1300,786661,605,318,287
38909,bombek87,1465,885039,604,389,215
49973,masakra89,1379,833349,604,331,273
136041,mlyko21,1350,815936,604,342,262
5617,dzispap,1370,826169,603,267,336
121321,harysia,1196,721366,603,228,375
505752,husaria,1537,926824,603,280,323
397767,messsalina,1332,803544,603,311,292
317091,tbb1866g,1332,803318,603,352,251
470058,wiilczynski,1280,772299,603,294,309
117543,cechaujot,1611,970144,602,303,299
552756,kaszmir88,1349,812463,602,323,279
101210,krychazielos,1347,811102,602,319,283
351001,mfs8494g,1338,805934,602,360,242
7375,pawell0990,1300,783176,602,241,361
14677,radziu1997,1317,792903,602,333,269
586,sasha027,1330,800805,602,318,284
151167,strazak01,1268,763810,602,320,282
23600,ggn2370,1240,745304,601,320,281
14168,notospoko,1414,849970,601,294,307
590909,azerakovsky,1256,754025,600,268,332
451850,kiedyizaco,1295,777069,600,389,211
623565,lestat,1309,785687,600,263,337
280238,panderoza8,1549,929865,600,293,307
301452,wgg498g,1401,841142,600,352,248
58414,wypadek2015,1292,775550,600,382,218
528130,bbn4745g,1257,753166,599,331,268
19054,jaca377,1399,838197,599,333,266
180015,lev3rage,1502,899973,599,318,281
286664,pilottv,1312,786121,599,369,230
443433,turni3j3,1582,947937,599,310,289
49467,abszyfiker,1296,775081,598,281,317
34308,cancerastrae,1211,724392,598,299,299
583162,ciosenko,1255,750798,598,314,284
406973,snw2016g,1219,729318,598,284,314
86086,bezstresuu,1781,1063257,597,278,319
607215,mach22,1420,848157,597,470,127
65326,mrzubr,1675,1000561,597,324,273
448721,sng8344g,1367,816341,597,367,230
46967,wydymala,1839,1098140,597,294,303
477590,lowelass,1161,692090,596,214,382
51565,neofx,1335,795796,596,282,314
10587,7seconds,1181,703256,595,239,356
38797,bezimienny07,1558,927342,595,334,261
25802,ciiinii,1407,837300,595,280,315
417258,crossholder2000,1134,675039,595,225,370
134692,markoanczyk,1477,879376,595,320,275
59085,moookra,1320,785945,595,307,288
3064,tomek03,1660,987989,595,530,65
282,asiabk84,1328,789395,594,283,311
31036,crewspeedee,1386,823569,594,342,252
9681,kruczek89,1320,784531,594,315,279
10237,moniaro,1424,846008,594,387,207
15912,rak2007,1331,791041,594,316,278
253105,gpm5114g,1248,740550,593,321,272
600786,kamilex07,1325,786031,593,346,247
22,misio135,1352,802267,593,222,371
385318,nauszyciemnie,1577,935488,593,347,246
92786,pjw692,1253,743065,593,322,271
10967,rupman,1506,893262,593,273,320
317026,tdi96,1211,718140,593,265,328
368110,kolagola,1480,876569,592,317,275
2952,marpapaag1971,1407,832950,592,323,269
75111,przegram20,1470,870550,592,194,398
584979,wiwatbarca,1634,967854,592,317,275
7289,asslan,1632,964850,591,337,254
320403,piotrek432,1631,964212,591,352,239
542405,wszystkodlacb,1617,956036,591,296,295
94443,arutar,1274,751981,590,311,279
20063,drifter1994,1342,791980,590,370,220
443355,pck6332g,1216,717850,590,299,291
177345,88chucky88,1291,760923,589,279,310
81852,florin93,1269,747774,589,263,326
416653,olsenbanden,1356,799205,589,245,344
86645,shemale,1963,1156749,589,310,279
293506,zaglebiedg,1729,1018486,589,353,236
588637,dmd5915g,1162,683788,588,218,370
10261,jezynkac,1313,772205,588,335,253
654733,juroqx,1352,795248,588,390,198
38192,adamar123,1321,775910,587,279,308
182726,angelaa90,1264,742175,587,339,248
160987,camillonex,1200,704559,587,257,330
329689,nnf4913g,1115,654727,587,194,393
179115,tww8741,1246,731429,587,306,281
3273,83czarny,1418,831290,586,324,262
38529,besson123,1334,782029,586,411,175
28048,dawnoniegrac,1592,933368,586,414,172
1819,huna1677,1398,819647,586,351,235
35404,mario171,1383,810496,586,430,156
476099,9rlndl9,1407,823204,585,292,293
11554,cwaniaranr1,1267,741362,585,238,347
185393,damcidodzioba,1275,746444,585,297,288
7168,gab2urlys,1270,743271,585,263,322
251477,kkf843g,1183,692491,585,233,352
656188,lider111,1225,717052,585,261,324
225,miodmalina18,1281,749866,585,320,265
286523,trawka1983,1245,728594,585,282,303
349538,boss8,1547,903623,584,395,189
466847,kampanowski,1514,884191,584,352,232
566718,nkw1835g,1354,790877,584,313,271
66069,cichy5561,1193,695924,583,224,359
244673,k0bietakot,1623,946316,583,443,140
574773,mmk3779g,1590,927196,583,421,162
37201,neohazard,1193,695547,583,227,356
1117,swirkom,1387,808651,583,329,254
20381,babuswml,1294,753355,582,252,330
106942,dajeszdajesz,1399,814358,582,332,250
92998,elizabet38,1302,758003,582,337,245
148172,fsk9906g,1567,912076,582,336,246
16029,garfildo23,1381,804133,582,378,204
501920,kubulas,1143,665244,582,185,397
85557,mercedes32cdi,1404,817630,582,351,231
483926,realmadridos,1414,823143,582,267,315
179454,supperstronk,1534,893132,582,341,241
216010,dtk8943,1329,772399,581,387,194
3753,dzys,1412,820721,581,291,290
310867,jakkas,1267,736667,581,328,253
620335,kft5813,1233,716820,581,275,306
420704,ktc5508g,1268,737162,581,227,354
556765,monika98p,1373,797855,581,343,238
207308,skubi84,1353,786655,581,296,285
571020,2minniegram,1344,779522,580,320,260
542915,bbd7121g,1369,794391,580,342,238
1236,blubo2000,1430,829781,580,269,311
90176,juzefofo12,1223,709417,580,278,302
200158,nowayouttrop,1406,815606,580,362,218
532091,prawie25,1434,831732,580,321,259
75334,przyczlap,1307,756899,579,306,273
3506,tomekkli,1416,819980,579,300,279
433368,alinak,1436,830537,578,345,233
3342,aza15,1274,736807,578,310,268
71515,bezmydlacp,1288,745028,578,359,219
1855,bodzio1111,1523,880358,578,304,274
143820,marol13,1351,781391,578,348,230
601733,mgt374g,1371,792544,578,330,248
474465,natalia551,1199,693521,578,249,329
295750,norbitorun,1289,745165,578,322,256
216850,aabudabii,1287,743141,577,303,274
268101,indraxdp,1290,744789,577,360,217
266355,mrrobert82,1289,743975,577,333,244
10449,muryn,1290,744623,577,240,337
492990,tom85,1282,739912,577,309,268
565967,1smok1,1384,797480,576,245,331
634812,dss9989g,1269,731086,576,358,218
103478,piotrczop12,1284,739684,576,332,244
355840,rene998,1289,742641,576,324,252
33206,sa1985,1438,828532,576,317,259
14913,zakuuu,1436,827227,576,340,236
5695,chomik322,1368,786781,575,298,277
616915,krupier21,1492,858265,575,294,281
25175,msciwuja,1352,777752,575,270,305
185392,papatata1,1251,719522,575,295,280
480,bweingeruje,1861,1068364,574,325,249
98515,rozerio,1479,849105,574,418,156
43295,xetheernoord,2125,1219867,574,276,298
4016,automix1,1427,818019,573,346,227
332982,barbusia123,1149,658579,573,200,373
620584,bsg8925g,1376,788880,573,273,300
1233,krynol,1268,726758,573,283,290
304,luxorten,1264,724705,573,261,312
3943,madridistasss,1454,833205,573,306,267
352620,nomineus,1244,713011,573,296,277
7277,wawerwwr,1296,742736,573,253,320
195243,dmg6708g,1378,788437,572,321,251
6133,lewap222,1360,778429,572,334,238
484,ojmichal,1539,880353,572,297,275
5413,scharlotte18,1254,717547,572,276,296
247299,szusblech,1446,827194,572,311,261
39344,tomi9492,1259,720692,572,313,259
7974,isaha,1440,822289,571,295,276
162381,madej95,1250,713793,571,252,319
25174,daw003,1323,753345,569,375,194
550874,maxxwell,1738,989213,569,365,204
376791,r0pek,1650,939049,569,301,268
177331,gsd9503,1215,690224,568,250,318
63518,krzysieksss1,1442,819436,568,321,247
1732,sirlore,1383,786021,568,303,265
475330,wcn7347,1367,776737,568,399,169
18233,jedzmagnez,1305,740054,567,250,317
6332,mariu71,1270,720236,567,291,276
129226,xgolabx,1389,787663,567,273,294
86085,bern2014,1382,782684,566,304,262
24022,jarko1001,1288,729188,566,310,256
5246,krzysztof128,1370,775451,566,281,285
2498,smakjejust,1938,1096973,566,290,276
538561,citko94,1697,959150,565,357,208
255883,dominisia22,1230,695415,565,321,244
381142,forseti86,1359,767906,565,336,229
26321,gabusia95,1076,608400,565,141,424
142359,gsf5883g,1298,733779,565,315,250
40210,guitarman,1510,853372,565,284,281
59000,kajmanbrzeg,1173,663303,565,226,339
182709,therealziomek,1247,704667,565,315,250
1644,mccoy1,1313,740968,564,303,261
650564,nbs6254g,1506,849900,564,493,71
87477,nieu,1339,755627,564,297,267
57174,roblox,1434,808935,564,307,257
150770,szetr11,1296,731170,564,292,272
399019,gbw6595g,1195,672792,563,303,260
376632,kercher6,1658,933888,563,437,126
349,koala31,1408,792824,563,369,194
10725,rzesz0w,1437,809314,563,260,303
280259,bleckshadow,1578,887325,562,339,223
4527,ninja4funn,1442,810508,562,385,177
2485,ogorkii,1384,778187,562,336,226
126876,ordonpl,1206,677929,562,240,322
34108,satyow,1442,810590,562,349,213
451851,xeanionpl,1163,653646,562,189,373
383377,baroniasty,1243,697589,561,296,265
476635,ffs2666g,1425,799549,561,312,249
231678,gkf9346g,1222,686059,561,335,226
77322,lenistwo0,1446,811255,561,303,258
213187,mrms6673,1518,851783,561,335,226
568806,nmm5137g,1298,728321,561,330,231
63989,cezar1910,1399,783827,560,341,219
121354,karolex78,1544,864836,560,256,304
8468,krzysio208,1171,656265,560,227,333
2754,paletka2014,1388,777438,560,261,299
82294,adrian1989ka,1418,792989,559,338,221
20397,ewro,1405,785605,559,317,242
24869,gumisiowy14,1122,627509,559,180,379
281616,skalus90,1386,774787,559,286,273
428519,tkb6044g,1353,756742,559,328,231
158478,wojak1322,1160,648514,559,240,319
92833,eliaszek69,1333,744205,558,276,282
596011,fmc3000g,1258,702349,558,303,255
50654,hiszpania,1878,1048202,558,319,239
173804,triczki,1482,827298,558,292,266
185137,ziomektykky,1209,674976,558,253,305
105053,27x27x27,1406,783541,557,263,294
579869,4kilaseru,1957,1090425,557,434,123
101138,amolit,1359,757393,557,327,230
248,dan196,1256,700131,557,261,296
36189,thc234,1341,747488,557,384,173
1493,2pak45,1291,718036,556,287,269
130673,browar504,1347,749213,556,318,238
491089,kramsone,1513,841730,556,320,236
326980,mar1a,1263,702638,556,259,297
579625,mokrykot,1299,722308,556,296,260
412,piotr016,1287,715983,556,296,260
167015,salaciara,1737,966316,556,309,247
97,sfx2,1434,797797,556,320,236
622685,szymek001,1233,685858,556,272,284
475474,bsf4092g,1478,820420,555,405,150
104513,grandmum,1423,790258,555,355,200
7585,maxiok18,1426,791784,555,352,203
59647,pogramnaluz,1403,778751,555,288,267
432137,rafaloo24,1293,718060,555,318,237
107,sap,1435,796928,555,282,273
78652,lukas1221luk,1312,727302,554,331,223
517376,natret,1350,748070,554,387,167
4162,neowalas,1296,718042,554,271,283
14333,1zl,1538,850676,553,314,239
100976,bezkompromisu,1443,798144,553,264,289
493972,dumabarca,1578,873127,553,291,262
66817,januszlasica1,1237,684206,553,244,309
29556,kriss2a,1389,768582,553,395,158
354681,nogaa,1409,779571,553,355,198
236876,nts8537g,1501,830068,553,286,267
84381,paleciak18,1377,761997,553,410,143
599117,pdm711g,1293,715534,553,274,279
3918,solverrr,1526,844331,553,312,241
160892,wwwolekpl,1392,770124,553,306,247
544032,kartypan23,1476,814877,552,301,251
618937,konserwat,1379,761627,552,362,190
167483,majkelck,1228,678108,552,250,302
544291,marionetka1,1670,922046,552,287,265
45204,pat95lol,1298,716677,552,294,258
3827,teiger2002,1256,693473,552,263,289
185072,ntk5433,1360,749471,551,342,209
41515,ranger5,1238,682372,551,282,269
1428,rmks12,1383,762290,551,318,233
75726,widmotk,1623,894391,551,285,266
60608,bartazar,1175,646792,550,219,331
479103,bismarckievtz,1407,774329,550,304,246
596698,bumbus16,1436,789827,550,361,189
76817,eluder,1251,688196,550,221,329
899,hellareisen,1483,815878,550,300,250
626363,lewy174,1421,781841,550,416,134
16377,piotrexs,1930,1062014,550,273,277
115782,salutuj4,1244,684514,550,239,311
37852,wiktorma8lat,1146,630663,550,197,353
597664,kekekegmd,1238,679804,549,271,278
56305,mlodym1994,1269,696971,549,277,272
375793,bryczas82,1272,697548,548,318,230
192207,lick,1753,960719,548,326,222
17660,prezes803,1340,734543,548,268,280
71413,xnehfajlos,1431,784395,548,228,320
7390,zycieee,1402,768337,548,310,238
394,marianwyszogr,1454,795570,547,372,175
26242,tojap,1497,819019,547,274,273
202600,al00x,1383,755284,546,237,309
665547,mordo15,1352,738494,546,369,177
313698,pom23,1449,791373,546,318,228
101965,skp3413,1234,673784,546,304,242
874,wesolutki1,1285,701634,546,271,275
7500,jacunio99,1351,736595,545,254,291
108279,marcinx240,1359,740859,545,390,155
5792,modertoking,1531,834513,545,310,235
561077,szpilagros,1201,654658,545,232,313
189994,1985,1621,882202,544,237,307
484077,cpn2802g,1387,754711,544,325,219
69033,daseee2,1231,670017,544,246,298
222737,izolacja,1153,627234,544,203,341
171090,twalcott14,1355,737483,544,343,201
176868,dymamkoze,1372,745510,543,307,236
81623,ibraagde,1179,640519,543,201,342
445623,jaguar7,1432,777870,543,397,146
274337,kbs07,1266,687743,543,285,258
121370,lubiegracisra,1948,1058045,543,370,173
30656,mateuszjwp,1722,935144,543,301,242
13783,matrix18a,1261,685042,543,296,247
14990,muerto,1502,815956,543,276,267
330714,rolnik15,1662,902637,543,404,139
419664,algunos,1293,701280,542,325,217
124599,kooolll,1342,727570,542,314,228
557550,kwm9116g,1428,773985,542,403,139
97823,niedobry1978,1197,648835,542,229,313
42117,szybkipilkarz,1596,865409,542,221,321
409522,twojrywal,1391,753996,542,357,185
202428,maciu11,1288,697318,541,243,298
5147,pokeymon,1379,746410,541,319,222
151205,wuuuuuuu,1707,923772,541,314,227
503530,gabrysiazd,1218,658003,540,268,272
20195,marcinrod,1349,728845,540,282,258
188692,nowy4321,1529,825971,540,301,239
523889,sbn531g,1180,637222,540,176,364
394778,zbyniek89,1252,676091,540,252,288
82717,aniosejo,1424,767762,539,287,252
44762,ariado,1428,770144,539,352,187
488,brodinho,1336,720553,539,263,276
10924,leszegg,1299,700482,539,264,275
23622,miszczkosci,1135,612184,539,162,377
29739,mrokicka,1417,764256,539,357,182
240031,omenik91,1286,693225,539,293,246
120460,tristen1983,1268,683503,539,277,262
72866,winogronek321,1235,665683,539,300,239
401329,disowsky,1721,926351,538,306,232
21926,fiferek91,1326,713436,538,338,200
166526,m00rdeczka,1320,710648,538,290,248
92407,miieszko,1727,929305,538,221,317
2738,natan89a,1133,609892,538,171,367
140607,palikosik,1530,823637,538,204,334
112411,aro145,1296,696177,537,260,277
240697,fdg966g,1293,694821,537,284,253
157264,fybyny,1494,802628,537,376,161
24050,hmcalifornia,1540,827043,537,305,232
15719,jazz,2100,1128084,537,427,110
135654,vvyrywanyzesn,1617,868537,537,307,230
172980,bcn1535g,1283,688143,536,324,212
240070,cfk1601g,1314,704565,536,280,256
151678,cpscwags,1229,659041,536,248,288
5833,dorotka79,1474,790525,536,344,192
53588,jay99,1248,669176,536,238,298
599314,kosnho,1334,715291,536,318,218
283975,bnn8396g,1403,750771,535,374,161
669297,kfm1219g,1773,948865,535,373,162
179937,olokzn,1680,899187,535,298,237
126360,startbrzeziny,1668,892472,535,274,261
440729,appogeum,1217,650058,534,270,264
87309,cheti,1468,784084,534,333,201
458135,klaudia30,1395,745214,534,286,248
4972,michal8mk9,1270,678496,534,237,297
7184,szymek1129,1377,735695,534,327,207
211665,tango64,1302,695670,534,328,206
527912,antioch,1804,961659,533,346,187
72403,ciacho92,1314,700626,533,295,238
61127,jowik1,1219,649870,533,250,283
323975,pcc6169,1164,620628,533,235,298
25646,pikuc,1342,715350,533,278,255
70524,2014aga,1529,813695,532,374,158
8734,kamillooss,1297,690016,532,291,241
636735,pirania1111,1293,688311,532,214,318
375818,tsn4282g,1315,699715,532,240,292
41869,wiedzmin20,1290,686280,532,251,281
787,intensiv,1379,732380,531,251,280
501251,cfm1641g,1820,964829,530,316,214
19973,jaszcur0075,1366,724416,530,254,276
2835,karolc26,1413,749340,530,322,208
574316,rad0m,1531,811446,530,266,264
409121,shift69,1577,836064,530,267,263
189463,brzezol,1298,686946,529,256,273
485056,dddd27,1349,714041,529,368,161
9534,klos1111,1398,739953,529,283,246
42489,mistszuniek,1645,870381,529,256,273
3674,natalia3007,1319,698243,529,297,232
411171,paulina918,2070,1095047,529,382,147
571274,piotrek5432,1416,749224,529,399,130
1221,r1cartwright,1347,713021,529,228,301
136042,rafalpeski,1247,660155,529,267,262
1842,blackonblack,1405,741876,528,314,214
31693,chlop1234,1261,666197,528,281,247
2484,chudy78,1226,647400,528,264,264
247463,dkn9144g,1425,752655,528,304,224
525245,gkw6101g,1368,722435,528,227,301
614688,kpt1600g,1334,704494,528,321,207
1368,vrx80,1352,714101,528,340,188
209357,1laracroft,1661,875766,527,368,159
319458,bpd9605g,1368,721131,527,330,197
539366,cytrusowapani,1140,601024,527,200,327
48794,mnb3931g,1267,667727,527,265,262
24486,profciekawski,1469,774528,527,259,268
277351,zoltakolba,1368,721443,527,297,230
31208,cipeleusz,1999,1051957,526,388,138
101837,maryjjusz,1332,701109,526,244,282
279,waski333,1436,755651,526,251,275
8596,anetaziolo,1216,638675,525,207,318
295697,dawidd6668,1332,699672,525,317,208
435919,gretchenross,1504,789905,525,314,211
23717,heli84,1174,616529,525,210,315
136744,jadzia57,1370,719610,525,240,285
647590,lepkavy,1373,721019,525,344,181
394709,lunia,1190,624846,525,228,297
6720,marekkorona,1328,697321,525,361,164
100074,onizyja,1436,754262,525,267,258
503003,pkt763g,1162,610395,525,223,302
223321,robercik88,1312,689083,525,308,217
232550,snt2181,1345,706500,525,248,277
112779,st6lub,1312,689309,525,264,261
590908,forrial,1335,700051,524,323,201
422451,kfc993g,1284,673110,524,226,298
910,kolo6691,1375,720508,524,296,228
93006,krzysio1986r,1166,611391,524,191,333
298070,kst529g,1905,998413,524,398,126
181729,lulaa123,1329,696764,524,232,292
480008,tnd5697g,1381,723691,524,308,216
35109,zakochanylove,1413,740609,524,264,260
568378,ccc233g,1293,676643,523,278,245
2025,danytuj09,1404,734349,523,293,230
138486,jorge99,1377,720287,523,289,234
5109,maya1984,1335,698684,523,290,233
463990,mnd1565g,1374,718686,523,324,199
34231,pietrzak,1307,683827,523,269,254
1201,touring328i,1428,747164,523,293,230
36697,voovspm,1417,741143,523,340,183
456853,wkw1916,1293,676409,523,263,260
253206,aga0o,1491,778571,522,274,248
88385,arti0770,1231,642919,522,240,282
384724,axe111,1523,795441,522,265,257
588379,eeal,1453,758869,522,293,229
1214,hamilton17,1802,941104,522,289,233
3246,hyudai15,1299,678104,522,205,317
54062,kameleon1225,1386,723930,522,313,209
4814,oolmaciek,1356,708038,522,254,268
14519,dani791,1320,687960,521,311,210
514579,dwt4791g,1209,630047,521,255,266
327622,fng3867g,1284,669132,521,245,276
2414,joam54,1254,653559,521,237,284
313117,klopsztanga,1460,760710,521,308,213
23733,nina0599,1270,662153,521,263,258
157778,seycam,1495,778916,521,211,310
58641,duckadam,1264,657697,520,242,278
93443,gnabgnabgnab,1260,655482,520,267,253
59020,onlyguess,1181,614391,520,226,294
209398,pikprzemek,1206,627492,520,218,302
105308,samsung207,1459,758870,520,327,193
39701,szymonf1989f,1416,736400,520,363,157
259246,uczesssiegrac,1414,735665,520,252,268
572454,wildgirl,1224,636708,520,275,245
77015,dawid0j,1219,632791,519,263,256
328358,fsm5547,1264,656452,519,302,217
67229,hahahu,1338,694772,519,280,239
24807,pawulon83,1320,685142,519,289,230
216539,saffis,1515,786719,519,316,203
95639,whitemagus,1917,994964,519,312,207
98174,bodzioch14,1171,606927,518,239,279
248559,gfw5591g,1426,738912,518,308,210
782,giblartar56,1709,885615,518,269,249
28132,haruhi,1884,976082,518,351,167
191308,hazardovvy,1709,885673,518,297,221
87473,porsche918,1498,776240,518,286,232
239351,tbb8794g,1155,598344,518,189,329
225736,tooseja,1231,638170,518,261,257
296534,wkp1612g,1359,704350,518,301,217
181523,gramy100,1373,709949,517,267,250
6414,krzyktol,1541,796845,517,356,161
331839,nawigacja,1926,995996,517,379,138
135921,pysskata,1508,779779,517,256,261
33948,rafi87,1271,657401,517,239,278
101798,szynszyleek,1170,605243,517,207,310
180529,1ona3,1189,613788,516,223,293
311539,adrian2392,1177,607360,516,216,300
229877,al777,1260,650209,516,232,284
333034,danieljaw2,1210,624850,516,250,266
125604,delkimcarp,1373,708711,516,258,258
341115,hammurabix,1442,744343,516,235,281
261010,mag0g,1756,906594,516,319,197
3779,ryryry,2002,1033192,516,280,236
58014,vmajster,1279,660105,516,325,191
6930,ccc617,1324,682038,515,359,156
486647,chrup3k,1732,891988,515,260,255
339744,debeer,1256,647073,515,207,308
119390,e3nter,1392,717275,515,301,214
370879,gft1452,1381,711285,515,282,233
611,jakubczerwo,1465,754612,515,329,186
27441,sqnos,1364,702466,515,270,245
592,tabaco80,1402,722397,515,305,210
601109,arooo,1304,670295,514,297,217
1055,cycatkaa18,1714,881495,514,340,174
374260,danutaprz,1229,631707,514,304,210
537031,edzia1012,1338,688061,514,363,151
45889,komfort205,1252,643930,514,221,293
92268,mecisz1985,1387,713257,514,282,232
805,pomyleniec1,1270,653180,514,258,256
10889,szpregel,1239,637112,514,292,222
433874,wojaktorun,1346,692172,514,273,241
21657,asdzxcv,1379,707860,513,298,215
550584,bkc2653g,1247,640032,513,208,305
208680,tnn1610g,1202,616875,513,244,269
449366,kpm153g,1364,698421,512,327,185
597185,pcm6428g,1516,776249,512,277,235
94439,poldekdwa,1414,724108,512,287,225
31798,scauter,1355,694001,512,251,261
35971,vvejherowo,1744,892964,512,261,251
112898,inferno0,1567,800797,511,267,244
555282,mfk8712g,1134,579748,511,160,351
67420,pawloss941,1281,654784,511,248,263
698,skr0mny18,1768,903698,511,284,227
234029,wladek222,1346,688091,511,362,149
515131,cnn5600g,1327,677079,510,290,220
1182,diko83,1373,700604,510,338,172
185457,duzawredota12,1293,659508,510,320,190
42315,edziaszek,1409,718780,510,317,193
20900,losingmygame,2001,1020601,510,316,194
24119,myszar12,1055,538441,510,144,366
118924,natkoss,1255,640241,510,259,251
134676,niewieszkto12,1394,711303,510,263,247
52606,wolej34,1428,728594,510,245,265
462013,gimbokurnik69,1269,646360,509,308,201
475737,kcs7789g,1387,706126,509,309,200
493209,khanas,1291,657527,509,278,231
9830,luck83,1376,700518,509,236,273
51289,mariox16,1281,652527,509,286,223
6555,matvaa,1413,719472,509,320,189
113444,miazgapl,1402,713665,509,292,217
2442,pawelelk,1873,953492,509,233,276
75377,putinowicz,1579,804031,509,357,152
562757,szpadyziusz,1344,684598,509,335,174
27109,xendx,1550,789272,509,258,251
68840,zaevu,1560,794262,509,261,248
16931,artur2004,1345,683623,508,342,166
486186,emilradom,1284,652358,508,269,239
542181,htsi,1326,673914,508,322,186
271867,madimario,1174,596654,508,201,307
6571,odkrec0na,1238,629150,508,290,218
162270,pr0elo,2107,1070499,508,391,117
443985,jarekgst,1258,638050,507,273,234
593289,kgb2901,1272,645182,507,282,225
221146,lifeisbrutal,1805,915531,507,298,209
434010,mwp2054g,1349,684335,507,351,156
177314,nnc4850,1396,707993,507,349,158
37935,pufpuf123,1207,611956,507,252,255
240429,spt7747g,1435,727896,507,286,221
38979,zjemciklapki1,1355,687240,507,315,192
228653,ftw6698,1286,650719,506,251,255
608699,gff7403g,1449,733334,506,269,237
103535,lekcjasurowa,1414,715496,506,360,146
87704,lidzia1802,1365,690850,506,336,170
185489,marioncat13,1361,689020,506,238,268
157431,need2go,1604,811651,506,294,212
229386,stryjak,1353,684870,506,253,253
12288,swojsamoboj,1460,739145,506,266,240
94648,tajfunix,1219,617185,506,215,291
369743,trochemizimno,1310,663119,506,293,213
225307,wnn8106g,1417,717368,506,349,157
399837,wsn3746g,1148,581120,506,226,280
440282,1ja2ty3my4,1392,703395,505,301,204
446801,bpf9585g,1432,723339,505,370,135
334437,jachu93,1312,662880,505,246,259
552386,kdh0iceman,1458,736405,505,308,197
148590,misikusan,1425,720081,505,304,201
165561,mistrzynka17,1265,639170,505,232,273
58111,pablo7no,1293,653356,505,278,227
44732,piotrekbud,1404,709025,505,311,194
6802,shrekky,1525,770199,505,328,177
177871,xeon17,1263,638059,505,253,252
380880,xyz900,1226,619479,505,234,271
561577,angel17,1216,612971,504,266,238
16434,bonnezz,1683,848246,504,259,245
108713,dzidzej,1305,657906,504,277,227
550062,eriol,1720,866888,504,290,214
640162,gp91,1402,707089,504,259,245
2137,jack1new,1238,624271,504,212,292
402283,sawik28,1378,694585,504,327,177
466660,sqb84,1350,680703,504,276,228
529645,fazimeg,1227,617337,503,232,271
51769,gifer,1309,658792,503,296,207
475883,gwk3113g,1388,698278,503,281,222
466243,luisnazario9,1420,714346,503,205,298
490372,nkb5537g,1334,671359,503,257,246
643562,ddd9969g,1224,614923,502,220,282
276931,ffp940g,1536,771176,502,287,215
105792,niepokonanosik,1306,656049,502,274,228
568661,rino1981,1256,630672,502,246,256
39375,00tlen00,1419,711073,501,179,322
425270,kafifi,1426,714865,501,386,115
444493,kardinale87,1179,590923,501,213,288
313942,napis,1945,974723,501,327,174
51353,pitupituszka,1238,620299,501,247,254
296006,kfb4990,1371,685679,500,319,181
27594,mazolinka77,1290,645057,500,224,276
250523,mistrzkanasty,1772,886013,500,417,83
76527,ralfeusz,1448,724437,500,330,170
1587,bladsystemu,1269,633639,499,251,248
321147,dwf7063g,1352,674818,499,214,285
98543,neotools,1354,675822,499,254,245
308887,nng3696g,1033,514888,498,119,379
12329,ppatrykkosa,1303,649001,498,218,280
1447,skobo,1456,725340,498,284,214
566196,dfd777g,1301,646900,497,252,245
338966,gfdj,1463,727326,497,258,239
3267,twexter,1390,691162,497,252,245
65946,wuko7,1242,617767,497,252,245
40818,czocher94,1334,661785,496,288,208
581942,darecki75,1193,592096,496,194,302
588700,dwt524g,1524,756130,496,280,216
10649,justajp,1263,626748,496,263,233
357883,kaufland2,1194,592338,496,277,219
55323,laksacja,1847,916546,496,287,209
36483,marcelino2312,1473,730938,496,232,264
576403,pleyer,1511,749680,496,303,193
610874,qta,1237,613571,496,249,247
77641,bartol1333,1273,630259,495,283,212
464683,berdzi32,1337,662206,495,279,216
20987,darzek345,2203,1090514,495,295,200
101438,fakenik,1341,663838,495,311,184
389913,lasznikow5,1370,678188,495,238,257
572901,pawcio4hej,1484,735066,495,292,203
150043,suchy0411,1308,647521,495,242,253
89457,wojowen,1232,609914,495,212,283
7613,ziele2004,1481,733161,495,238,257
531100,qwertyhgfdsa,1680,830409,494,344,150
121461,slabyalewygra,1303,644064,494,185,309
28170,adifani999,1324,653034,493,267,226
620,duzarakieta,1351,666361,493,241,252
335565,fbb7335g,1352,666656,493,250,243
13192,hells0,1307,644756,493,292,201
362857,lechiasa,1408,694400,493,270,223
169872,pastoruss,1268,625561,493,263,230
357089,przemkox11,1251,616930,493,258,235
199612,wielkiszu89,1339,660607,493,295,198
239227,wolna36l,1240,611430,493,273,220
20673,wsk125wrc,1846,910146,493,284,209
138,0oalicjao0,1288,633845,492,216,276
548108,ggb9908g,1241,610934,492,278,214
1099,pawelmrok93,1466,721367,492,328,164
213948,ppc329g,1353,665823,492,279,213
12993,przelon,2169,1067301,492,276,216
380081,x6x6x6x,1367,672751,492,363,129
510580,darlene26,1192,585572,491,232,259
12919,krzysiekvirus,1616,793924,491,213,278
5225,mariusz86x,1321,648689,491,343,148
360497,ckt9636g,1255,615280,490,236,254
154848,dawsson,1491,730682,490,294,196
100697,grisza83,1562,765671,490,403,87
210401,mariusz85p,1179,578193,490,190,300
32561,robert6923,1366,669643,490,238,252
1820,fox1981,1421,694891,489,311,178
1867,melman121,1448,708227,489,243,246
494920,pingipongo,1242,607564,489,246,243
29903,przemyslawooo,1229,601276,489,231,258
227050,cubana1,1340,654341,488,277,211
61140,dyniowy2,1364,666086,488,282,206
575950,gramsobieijuz,1348,658196,488,300,188
4017,jimi1oom,1402,684525,488,312,176
40667,justus,1607,784626,488,214,274
71201,krjw,1452,708636,488,247,241
1975,matys1992x,1288,628647,488,200,288
131517,kaszelpalacza,1348,656688,487,244,243
71392,kryssttek,1297,631866,487,277,210
88158,llitur,1980,964555,487,248,239
77091,adrian355,1291,627860,486,248,238
8505,augustgold,1208,587412,486,181,305
281577,beggi82,1415,687795,486,338,148
22303,marquss,1350,656529,486,265,221
418700,mich9999,1346,654376,486,240,246
543979,ngs7187g,1371,666672,486,310,176
40533,radekzetka,1316,639643,486,223,263
26223,sofronov,1736,844047,486,285,201
59255,zuzia1357,1368,664953,486,356,130
455633,dawidjanikowo,1288,625151,485,237,248
63913,malygryzon31,1368,663628,485,346,139
34837,zagramityle,1404,681159,485,291,194
154148,cosinus72,1369,662812,484,255,229
437680,mmb1473g,1165,564034,484,183,301
39527,daniel43210,1317,636212,483,302,181
998,dumle,1534,740984,483,377,106
348467,glady,1271,613951,483,265,218
43130,kamildinho,1363,658561,483,336,147
297209,magnemite,1469,709573,483,238,245
185623,wgd4767,1357,655453,483,243,240
159702,ctw1567g,1229,592510,482,236,246
208013,dtf8839,1201,579159,482,208,274
6496,eneo20,1329,640875,482,299,183
127086,gambo1,1712,825365,482,268,214
22023,gronekw,1318,635596,482,197,285
95350,matih11,1339,645848,482,206,276
171925,migdalena,1358,654601,482,328,154
375862,soolik1990,1318,635662,482,242,240
582140,spanczbob,1256,605827,482,249,233
10808,asrock,1667,801981,481,226,255
73308,bartek108,1442,693865,481,286,195
53559,cjmati1995,1373,660819,481,341,140
11087,feszter,1493,718564,481,276,205
61980,osowialy1,1351,649910,481,236,245
144433,silnykac,1778,855663,481,267,214
114843,tmw4530,1216,585163,481,183,298
210453,varomix,1459,701889,481,354,127
5832,zephyr550,1279,615360,481,242,239
348505,b773,1374,659707,480,239,241
9201,chleb33,1043,500798,480,115,365
203398,dsw6660g,1323,635141,480,273,207
65877,fwf7134,1185,569237,480,216,264
203,galantez,1323,635119,480,218,262
106921,koper002,1340,643288,480,284,196
326005,kreator10,1117,536612,480,158,322
1330,magska,1440,691299,480,244,236
187354,nelly13,1333,639898,480,278,202
228700,cfd8837g,1280,613176,479,268,211
401161,ewelina34i5,1244,596297,479,300,179
2329,hellboyman,1261,604226,479,240,239
4717,matematykaxc,1181,565894,479,168,311
465353,orchida,1362,652628,479,270,209
6162,raffaello1992,1405,673374,479,276,203
605010,sznycpl,1506,721466,479,269,210
169623,tmt2337,1241,594588,479,220,259
24113,zbani,1838,880768,479,320,159
34940,90michal90,1516,724710,478,289,189
115736,fallen,2039,975069,478,273,205
394777,grzechu1711,1305,623824,478,276,202
98442,hardline,1823,871683,478,261,217
98193,heilmaster,1375,657547,478,231,247
449551,sdr11,1413,675645,478,243,235
5223,spider2310,1257,600961,478,263,215
511892,andkor89,1242,592687,477,240,237
628519,gor28a,1367,652124,477,330,147
237047,gubi,1325,632096,477,265,212
488833,knb6029g,1324,631756,477,248,229
54170,piteks83,1305,622961,477,214,263
1430,23klaudiusz23,1362,648546,476,264,212
21997,danielsio931,1314,625780,476,282,194
11605,imiennikin,1403,667924,476,250,226
161064,justadrem8,1369,651959,476,166,310
114970,lukikrz,1211,576593,476,197,279
1080,misiek86v,1336,636187,476,193,283
143124,tfc5269g,1195,569235,476,197,279
208001,wgw2957,1211,576733,476,205,271
99821,gamb0l,1704,809751,475,262,213
335,kochamcie,1913,908932,475,256,219
70941,lceufelectriq,1581,751343,475,219,256
494116,taksobiee,1514,719472,475,274,201
37805,vip440,1424,676799,475,189,286
235691,fwk2749g,1261,597959,474,232,242
245341,jestemwwannie,1524,722567,474,237,237
6971,lukipan,1369,648992,474,291,183
1072,luuckii,1331,631166,474,248,226
134137,mati1990p,1232,584399,474,235,239
30839,pablosoundmix,1341,636106,474,224,250
105983,patka31,1168,553913,474,185,289
1335,ryjeklow,1451,688247,474,297,177
336070,0ga,1760,832498,473,278,195
264223,feuerwehr,1326,627434,473,321,152
116210,part101,1409,666587,473,302,171
2881,slociszek88,1334,631033,473,205,268
507686,tdk182g,1644,777615,473,293,180
246088,wtopowicz1,1546,731594,473,329,144
139497,elpolako8,1413,667214,472,287,185
215930,fkp6516g,1469,693763,472,389,83
3768,lew65,1308,617391,472,247,225
1772,sebastianoo,1412,666896,472,205,267
310475,b0heme,1424,670709,471,254,217
162127,shlee,1372,646270,471,235,236
93066,szymon532,1178,555237,471,190,281
620190,wilkwcieniu,1399,659269,471,295,176
490764,zajdel,1481,697860,471,219,252
36146,chwilagry,1426,670500,470,292,178
446345,dacliffster,1130,531298,470,175,295
249005,irass1990,1477,694256,470,221,249
66506,krzysiek2401,1392,654606,470,310,160
9674,leonyy,1416,665909,470,215,255
42685,lszop,1347,633356,470,304,166
195398,mareckiwero,1389,653125,470,235,235
131296,sanczoopanczo,1196,562247,470,186,284
7805,sztuczkataka,1355,637111,470,210,260
334996,theqq,1225,575853,470,265,205
275869,bartekbogusz,1200,563039,469,228,241
46195,boiszsiepilki,1580,741371,469,251,218
280005,masujjdzika,1380,647273,469,277,192
46958,ruczekj,1487,697589,469,201,268
349726,bkc384,1413,661312,468,257,211
100835,filekthebest,1403,657044,468,367,101
235734,jashiru,1303,610262,468,293,175
110746,leomessi10,1228,574826,468,205,263
372605,maramarecki,1387,649333,468,273,195
348722,rafffiii,1397,653978,468,289,179
510579,scissorhandz,1204,563670,468,236,232
590126,tszycztery,1473,689726,468,263,205
266397,wwb7550g,1299,607955,468,214,254
422,zommi2,1591,744841,468,366,102
1088,iwan0296,1360,635301,467,224,243
51536,magnezyjka,1384,646347,467,279,188
236179,ppw1796g,1330,621513,467,305,162
187736,rubber,1243,580534,467,183,284
565606,aiaz,1672,779425,466,273,193
62875,aser0et,1271,592353,466,222,244
174739,cgk9532g,1537,716471,466,204,262
206931,contowsky,1205,561795,466,232,234
8750,dxsuinik,1273,593260,466,272,194
79394,n0popatrz,1633,760986,466,250,216
237910,npf5003g,1247,581289,466,216,250
728,olkakolka,1373,640032,466,258,208
3046,riven,1605,748305,466,232,234
76409,anda85,1325,616230,465,244,221
95653,dam1ann,1355,630220,465,236,229
348696,darob007,1281,595866,465,251,214
383,duncan12,1377,640458,465,242,223
47365,jarekku88,1372,638124,465,304,161
285799,kwp4112g,1269,590402,465,269,196
1963,mamut123y,1385,644183,465,252,213
361437,one4one,1503,699113,465,208,257
400215,roksorpl,1149,534723,465,172,293
450737,dawca0gazmow,1449,672446,464,255,209
390974,dws9152g,1457,676414,464,300,164
462684,gpt5425g,1282,595021,464,244,220
393397,niewiedza,1096,508795,464,170,294
140211,powitaniednia,1163,539803,464,205,259
13599,tomekk387,1296,601686,464,293,171
2287,v0x0v,1218,565212,464,192,272
48504,xmarianf,1314,609831,464,243,221
207445,delinkaaa,1328,614883,463,299,164
444094,ncw9669,1184,548413,463,193,270
49877,piot06,1245,576465,463,213,250
79660,chinezu83,1291,596792,462,298,164
175470,czuszek,1263,583911,462,246,216
590923,dkk7295g,1475,681669,462,296,166
170424,melancolieus,1237,571530,462,259,203
36546,2110wj,1448,667940,461,261,200
513364,87mj,1408,649124,461,216,245
264318,bambae,1422,655710,461,204,257
42730,ferwika,1312,605155,461,312,149
435,leszek1412,1263,582476,461,233,228
514661,maosoam,1239,571407,461,189,272
573635,1blue1,1474,678274,460,250,210
70034,dicele,1447,665900,460,264,196
512509,nikson86hx,1362,626898,460,249,211
382834,dtp296g,1132,519701,459,141,318
261014,fgt1652g,1255,576497,459,187,272
24822,michalwrobel1,1151,528492,459,175,284
1380,sliczna25,1453,667314,459,241,218
102216,bartzlo,1394,638850,458,266,192
250444,cct5174g,1349,618066,458,296,162
3692,cycata69,1387,635361,458,251,207
63020,dawid8817,1466,671868,458,312,146
4338,koper1010,1298,594828,458,185,273
17368,maine,1581,724410,458,193,265
265351,piotrgilpl,1249,572289,458,220,238
547088,ptm6811g,1393,638087,458,248,210
378095,rzepajr,1336,612148,458,290,168
486636,stt7513g,1338,613019,458,237,221
4904,bilek123,1254,573453,457,191,266
3791,boleklolekbol,1278,584446,457,217,240
55329,dududus,1609,733818,456,208,248
628972,moyshe,1266,577402,456,210,246
70560,prezes12132,1300,592869,456,229,227
25842,rafalgwizdal,1490,679713,456,314,142
202160,tks1593g,1378,628602,456,260,196
624,zuubbaa,1274,581373,456,210,246
515026,bgp2655g,1467,667796,455,226,229
203683,jestpompa,1336,607927,455,264,191
317582,kompw8,1250,568992,455,239,216
57276,kowal2316,1279,582114,455,256,199
8741,mika02n,1225,557717,455,212,243
243149,parzywo,1627,740582,455,247,208
22498,pawzg,1241,564916,455,249,206
47433,takisamjak,1251,569342,455,248,207
123232,virgin,1783,811272,455,329,126
268588,wiadrowicz93,1314,598001,455,198,257
48571,klawisz2,1197,543816,454,199,255
314112,lisek601,1300,590349,454,264,190
102327,mydelkofa123,1329,603625,454,321,133
37711,asia246,1426,646358,453,339,114
152527,bambaryloxd,1613,730861,453,235,218
557150,deathstroke,1416,641685,453,226,227
522139,fkn6633g,1290,584602,453,224,229
258658,kwadrat1,1456,659910,453,208,245
25346,ncs448g,1228,556389,453,204,249
414160,xixixo,1343,608676,453,237,216
556998,dwc587g,1280,578715,452,218,234
192936,eefbn,1444,652903,452,256,196
738,elbombero,1303,589283,452,235,217
170425,honi93,1193,539463,452,203,249
1870,melane,1430,646435,452,226,226
607208,moooe,1734,783836,452,276,176
2556,operes,1349,609808,452,226,226
439510,fcs2332,1332,600968,451,237,214
93696,kronlojter,1509,680659,451,282,169
39189,marze6673,1550,699084,451,266,185
228107,mrkondek67,1481,668204,451,340,111
1076,qba18,1381,622977,451,284,167
534394,skw4215g,1309,590767,451,263,188
131482,wykop,1369,617449,451,241,210
12860,awrylochcesz2,2157,970677,450,269,181
178799,sadzik12,1382,622021,450,218,232
552390,tr333,1387,624261,450,266,184
46923,tyciu85,1360,612212,450,232,218
238066,wdb3347g,1340,603275,450,270,180
426551,19oo,1442,647747,449,213,236
238823,agnieszka0482,1376,617882,449,303,146
98079,aspettaunpo1,1418,636906,449,266,183
436529,buddamonk,1580,709678,449,245,204
908,cristerano,1438,645874,449,313,136
420032,malapchelka,1460,655790,449,218,231
333615,mtd2526,1348,605526,449,269,180
294280,typowyraper,1207,542140,449,201,248
106036,babikklb,1321,592255,448,269,179
237217,bsc7869,1403,628947,448,313,135
424076,mwp4376g,1258,563995,448,210,238
446031,realfanclub,1582,709000,448,298,150
233304,totylkograon,1101,493661,448,134,314
552305,vig,1647,738061,448,285,163
341709,went,1666,746654,448,288,160
977,zamarski,1293,579326,448,264,184
80762,analnyspec,1617,722873,447,239,208
236385,briefcasejoe,1577,705362,447,227,220
585018,btn6878g,1363,609513,447,276,171
198561,kpc9797g,1243,555748,447,225,222
431049,mcm4321g,1343,600478,447,222,225
64726,griszaaa,1219,544058,446,202,244
231331,patryk99,1322,589889,446,290,156
120900,pietrus92,1206,538216,446,235,211
10888,tnakus,1182,527497,446,183,263
430384,zuras555,1268,565532,446,225,221
43015,28songo28,1226,545715,445,196,249
275745,cds2482g,1181,525903,445,197,248
141555,crookers,1316,585794,445,224,221
5074,dunik1988,1387,617242,445,213,232
553844,fdb802g,1534,682992,445,305,140
206532,fsm315g,1425,634410,445,263,182
63633,giaur66,1350,601097,445,234,211
283,hshshs,1439,640560,445,351,94
70053,jnnzmp,1426,634766,445,221,224
329650,koss51,1275,567646,445,194,251
636919,kubix222,1404,625216,445,314,131
10506,razvan77,1288,573289,445,239,206
420196,twb9970g,1226,545627,445,199,246
476236,dmf7288g,1250,555146,444,231,213
78740,dru000,1341,595604,444,261,183
555183,fdp3592g,1353,601131,444,257,187
236570,jamer,1263,561108,444,210,234
48116,jasion,1213,538679,444,205,239
1013,rabbit976,1294,574975,444,236,208
41077,roby1321,1546,686436,444,349,95
82609,voiceuofpolan,1606,713367,444,237,207
16031,fryziu,1455,644896,443,259,184
149639,iluki25,1359,602370,443,270,173
270350,kl2000,1360,602742,443,320,123
199143,l0s,1731,767087,443,252,191
2868,pouyf,1936,857829,443,235,208
553785,xef,1671,740319,443,212,231
18323,123johny,1404,620724,442,287,155
14781,czesiu1817,1375,607913,442,279,163
232320,martaw62,1246,551104,442,243,199
248359,mfb2029g,1386,612815,442,264,178
130509,armin116,1534,676801,441,219,222
109623,czasdotrumny,1308,576892,441,234,207
219,diez,1761,776674,441,249,192
628226,dzinodzin,1525,672827,441,224,217
631,grzegorz1002,1233,544068,441,192,249
741,kajtolinio,1427,629343,441,262,179
337487,mantekgagadek,1145,505238,441,144,297
425677,nsk7678g,1228,541741,441,205,236
10983,tevez86,1690,745357,441,265,176
2432,zasza,1281,565105,441,266,175
137555,71trener,1367,601785,440,254,186
10100,acrabm,1317,579719,440,263,177
20732,annaska,1243,547064,440,216,224
2763,chlopaczek21,1321,581548,440,191,249
115330,czalak,1269,558499,440,230,210
5320,debesciak,1389,611585,440,186,254
389875,hiress,1587,698525,440,318,122
148024,kerma4,1135,499523,440,149,291
635348,marno75,1237,544597,440,218,222
494856,mephinx,1280,563293,440,206,234
24494,playfon,1689,743438,440,268,172
91748,skor7366,1563,688094,440,264,176
646064,tmx28,1191,524308,440,192,248
56677,wegi0988,1194,525759,440,219,221
816,andrej32,1382,606782,439,213,226
2928,andziamati,1572,690487,439,375,64
21885,buncol1974,1269,557318,439,212,227
337748,buzka,1360,597198,439,216,223
9897,chriss,1914,840407,439,229,210
3618,n3tz,1242,545349,439,264,175
373660,nng9718g,1216,534258,439,206,233
269229,ssg3300g,1238,543653,439,230,209
451121,ah80,1370,600108,438,232,206
355256,kam3kam,1336,585525,438,283,155
66902,kazio84,1331,583037,438,204,234
2380,maron007,1368,599305,438,231,207
187924,natalkaz0,1276,559184,438,219,219
177849,souszibo,1266,554762,438,249,189
388183,sts9089,1139,498908,438,183,255
25231,1027,1484,648666,437,225,212
589,byczek01,1321,577701,437,212,225
385118,dejwid88,1183,517044,437,184,253
274342,fgw1398g,1288,563258,437,249,188
396,gurami74,1366,597289,437,216,221
353618,pdp2566g,1438,628506,437,238,199
57175,pleasure,1344,587721,437,211,226
96700,psemekkk,1247,545307,437,212,225
343930,slejer666,1250,546461,437,213,224
1923,szukammamy40,1219,532818,437,194,243
1858,gupower,1396,608952,436,252,184
4520,harusia,1266,552105,436,234,202
453338,uzytkownikgry,1620,706581,436,293,143
134348,zimur,1350,588817,436,259,177
220039,0banana0,1153,501924,435,168,267
185580,aleksandrack,1203,523705,435,183,252
550629,buleek,1626,707502,435,283,152
214698,ddfgg,1288,560608,435,230,205
2789,gowiththeflow,1505,654962,435,211,224
69369,krisu44,1387,603521,435,237,198
301974,miczuuu,1271,553110,435,244,191
156344,oszczany,1544,671983,435,235,200
26866,rosalie123,1247,542712,435,251,184
151741,mateo2,1219,529396,434,199,235
4457,noobsaib0t,1813,787189,434,239,195
552181,sdd8445g,1336,580093,434,253,181
254232,spb6899g,1393,604809,434,273,161
54897,ursuck,1859,807011,434,274,160
178649,basteczkowy,1414,612432,433,263,170
324375,cfk5041g,1205,522110,433,207,226
181431,czt,1610,697400,433,288,145
7323,grigorinho,1393,603535,433,226,207
68712,morphic,1568,679263,433,231,202
231607,nagis,1590,688556,433,235,198
158873,ngn6453g,1390,602175,433,265,168
70588,smigalka,1211,524744,433,185,248
535476,staniu28,1384,599438,433,269,164
22260,sulincho,1266,548230,433,255,178
42180,ytrak,1412,611493,433,267,166
131828,zszsw,1202,520606,433,158,275
192586,casperius,1314,567993,432,235,197
48680,hanvega,1401,605389,432,232,200
637953,kdt2528g,1284,554961,432,195,237
24875,kelner021,1277,552085,432,236,196
27867,ksk6369,1311,566721,432,275,157
610279,lukukasz,1223,528344,432,232,200
118616,steel2001,1289,557224,432,267,165
25988,bedson10,1286,554589,431,229,202
43119,dajziemniaka,1273,548713,431,166,265
447710,entp,1386,597789,431,211,220
41177,grzes0203,1420,612376,431,304,127
371159,gtf7471g,1327,572270,431,201,230
51438,jkb200,1230,530535,431,216,215
35530,leopart,1258,542488,431,193,238
419856,ponczulek111,1304,562061,431,255,176
253708,wicemistrzpolski,1290,556043,431,212,219
119188,bananor,1403,603300,430,211,219
48221,cukrowyhayd,1584,681498,430,222,208
400752,diaboliczek,1107,476068,430,148,282
74903,dmooo,1432,616016,430,318,112
263164,envel0pe,1404,603983,430,180,250
610715,eustach1,1180,507520,430,130,300
29578,grzesiekjablo,1316,565936,430,226,204
206485,krakwar,1195,513853,430,166,264
20860,krisuuuuuu,1487,639719,430,236,194
16004,kura0000,1220,524669,430,210,220
607818,tkn1212g,1266,544714,430,251,179
86943,tyson225,1289,554513,430,228,202
29834,1krzysiek009,1258,539802,429,204,225
388248,adamikofiko,1194,512439,429,183,246
11358,ajax181,1356,581849,429,182,247
29727,buziaczek8262,1249,535868,429,220,209
5976,denver1906,1369,587680,429,255,174
25912,dupcesie,1349,578850,429,186,243
43210,fajnaabicz,1304,559477,429,286,143
231200,jaro2255,1243,533415,429,237,192
5642,mario31lat,1302,558611,429,178,251
117710,masiaczek25,1373,589063,429,215,214
4301,tomeka5,1453,623591,429,274,155
72864,winogronek,1165,499846,429,171,258
98529,zawi3dziony,1610,690719,429,227,202
604237,44latek,1561,668199,428,237,191
46672,aniusiaa1992,1314,562680,428,261,167
234381,jacenty1177,1235,528844,428,263,165
558375,llvllollvll,1433,613476,428,225,203
556,minek88,1260,539310,428,187,241
547931,stp8410g,1169,500696,428,191,237
590885,uczesie97,1483,635045,428,210,218
148,70trener,1380,589501,427,238,189
109953,eland2004,1189,507723,427,176,251
230570,golpolgol,1469,627544,427,232,195
384226,lenin4112,1366,583369,427,212,215
4519,macz0s,1374,587010,427,202,225
4804,mario2203,1406,600706,427,206,221
589586,mss9462g,1313,560900,427,220,207
10726,nieskromny18,1642,701152,427,243,184
176270,pge93,1213,518160,427,202,225
385523,psb1916,1219,520874,427,205,222
629687,tpb867g,1195,510602,427,180,247
31760,trudny17,1490,636419,427,224,203
42434,cph4,2064,879557,426,284,142
553561,dotknijbalasa,1738,740394,426,242,184
38285,girll97,1407,599589,426,244,182
11998,hbs37,1323,563686,426,205,221
625891,intruzzz,1337,569568,426,210,216
191518,jm612,1717,731521,426,420,6
70280,madox,1374,585522,426,192,234
103756,magdas,1265,539049,426,182,244
350988,ooooorety,1320,562504,426,222,204
5686,peek,2065,880081,426,281,145
3135,fotzsyzrk,1388,590060,425,265,160
375290,gfm5106g,1375,584708,425,246,179
303730,gr7gr,1217,517318,425,178,247
36718,kijowski,1684,716069,425,222,203
71994,livesport,2174,924117,425,257,168
281359,maadni,1458,620015,425,249,176
18980,madrac,1376,585045,425,218,207
216232,milchkoze,1171,497910,425,180,245
199964,mlekopan,1185,503872,425,167,258
104839,ni30bliczalny,1671,710533,425,250,175
15579,oololoo,1411,600088,425,262,163
9669,skuter47,1388,590322,425,223,202
345290,tgc757g,1357,577077,425,275,150
641333,wmm4277g,1327,564137,425,229,196
75099,xxsandraxx123,1276,542643,425,230,195
114910,anoniim,1838,779573,424,227,197
19313,gieromaniak,1558,660944,424,323,101
247110,ihavetowork,1515,642687,424,187,237
103631,jasmina024,1268,538048,424,215,209
551847,kaszkadlalali,1690,716952,424,266,158
133385,sweetflower5,1241,526216,424,262,162
600398,thomy2017,1230,521549,424,204,220
14748,0zzy0sbourne,1757,743601,423,218,205
479795,cmg8362g,1380,583832,423,225,198
96088,holyhell,1757,743510,423,272,151
103619,kiper0050,1217,515141,423,217,206
276515,krysi0,1300,550181,423,233,190
5663,marcinnn1984,1381,584320,423,235,188
74435,mariobz,1359,574859,423,293,130
242499,marmir6673,1527,645942,423,255,168
10654,olek1122,1132,479049,423,142,281
72881,strw1233,1552,656610,423,307,116
172317,ccm5491g,1431,604130,422,343,79
574886,ctw5362g,1290,544767,422,224,198
364136,ffs4670g,1236,521625,422,181,241
609939,gkd5620g,1393,587856,422,269,153
15571,juras665,1282,541169,422,172,250
6552,mdkcbg,1532,646671,422,221,201
386519,mms3889g,1176,496293,422,181,241
444872,mnf2311g,1307,551825,422,242,180
25403,norfolk,1036,437389,422,91,331
56023,rohhf,1351,570282,422,206,216
115389,torcidaksg,1399,590394,422,265,157
170911,cbt7659,1255,528423,421,185,236
110857,danio6lat,1245,524194,421,239,182
1199,jachooo7,1404,591388,421,262,159
108805,kotkatk,1216,512166,421,214,207
1161,kuciapka88,1516,638524,421,220,201
217786,maszzlygust,1465,616983,421,212,209
76605,ogarnacskreta,1491,628022,421,195,226
136492,r0t,695,292790,421,80,341
110184,rapi2,1246,524710,421,173,248
322882,thcplus,1784,751107,421,251,170
16891,bialyyy8,1357,570046,420,236,184
17449,edek0909,1325,556736,420,224,196
7800,edol76,1500,630301,420,196,224
137214,hem,748,314193,420,132,288
81797,ixikus,1335,560805,420,195,225
438532,kkw308,1195,501910,420,165,255
73217,mav202,1278,537117,420,238,182
2961,r4iden,1665,699669,420,231,189
386297,skm4067g,1169,491320,420,157,263
198494,titsgirls,1409,592116,420,243,177
105724,wysilsie,1571,660186,420,208,212
475440,cmf2571g,1392,583504,419,264,155
122376,g0vn0,1576,660711,419,260,159
92683,gryczus,1334,559007,419,261,158
82370,gryglo2205,1316,551678,419,201,218
47797,kdk508,1356,568275,419,263,156
25169,krolwpilke,1504,630348,419,210,209
361138,kryniu69,1221,511828,419,163,256
141423,psd1936g,1379,577921,419,204,215
66093,sarrino,1335,559667,419,255,164
3829,slaweknawy,1376,576940,419,225,194
213286,slugg,1621,679302,419,255,164
626667,starygracz,1623,680360,419,205,214
9181,andreasik5,1393,582287,418,266,152
82858,barca531,1336,558555,418,280,138
212164,fnw6001g,1173,490392,418,168,250
290111,gggooolll,1464,612233,418,271,147
446249,gibkiromano,1329,555694,418,265,153
34741,gumijagoda12,1318,551338,418,157,261
1729,kitong,1654,691678,418,200,218
218213,kolowww,1322,552870,418,248,170
220208,malyfiu,1194,499166,418,176,242
101600,metaliczny,1370,573041,418,260,158
401,michal3625,1075,449669,418,113,305
373117,msm1762g,1055,441190,418,114,304
150646,swiety007,1182,494203,418,196,222
461756,uzurpa,1447,605140,418,249,169
571580,andzejgilotyn,1372,572446,417,249,168
189593,btf5912g,1356,565660,417,213,204
491312,cbm3434g,1182,493222,417,180,237
452063,cff6906g,1318,549703,417,225,192
476764,csg8325g,1288,537397,417,208,209
255076,cupkinson3,1293,539442,417,226,191
100327,jestesslabyzr,1436,599111,417,193,224
26233,jpd3479,1403,585070,417,322,95
51219,laliga90,1308,545803,417,193,224
16477,morvid,1216,507221,417,169,248
4965,natala180,1359,566724,417,202,215
80359,zajamo,1618,674974,417,255,162
328597,zrobmischemat,1713,714558,417,247,170
191491,dss9832g,1733,721232,416,264,152
6514,gkm6881g,1173,488188,416,163,253
41554,janlllll,1452,604241,416,230,186
152155,kfp7793g,1057,439889,416,61,355
810,krzytek,1287,535632,416,230,186
63328,misiaaxx,1407,585475,416,255,161
587501,olololo1976,1442,600181,416,284,132
216615,omen626,1349,561520,416,296,120
57728,rozowyokular,1586,660094,416,222,194
31450,waskiwas,1958,814714,416,214,202
197125,zastanawia,1450,603333,416,160,256
153911,andrych21,1388,576234,415,234,181
28401,bemuto,1426,592111,415,240,175
526963,damian3524,1219,505963,415,188,227
343013,dks1717g,1263,524557,415,188,227
548325,fkk3826g,1320,548160,415,194,221
147792,lover23,1235,512754,415,228,187
70020,marcelq,1462,607002,415,194,221
18646,mka63,1396,579561,415,284,131
94583,vovk,1630,676486,415,198,217
67393,wojok151,1318,547350,415,200,215
66950,emilooooo,1288,533637,414,239,175
23076,haoxy,1595,660460,414,211,203
17599,jagata82,1469,608387,414,180,234
407245,joasia2157,1207,500068,414,194,220
5982,kash17,1289,533945,414,207,207
60299,michalgo,1246,515847,414,197,217
3062,psychorap,1899,786330,414,268,146
2954,trol165,1422,589071,414,223,191
619216,bpc9118g,1458,602445,413,216,197
306,cinciek,1551,640717,413,210,203
166677,fnk4363g,1300,537287,413,212,201
20456,klaudynka95,1234,509874,413,192,221
395376,maral,1298,536251,413,196,217
179798,miernakotka,1474,608882,413,215,198
12893,przemo03,1274,526233,413,241,172
5625,qra23,1403,579765,413,231,182
259503,twojstary644,1258,519615,413,198,215
195005,wlochatybobr,1224,505517,413,159,254
47184,bebcio1985,1274,524892,412,146,266
2199,belchatow,1787,736549,412,223,189
454848,bimber76,1395,574807,412,226,186
32825,deathas,1310,539757,412,144,268
594518,dzikasmietana,1178,485383,412,183,229
311501,faaarciara,1580,651140,412,280,132
594519,kicia8422,1221,503417,412,229,183
420092,konkastla,1520,626417,412,266,146
15473,kopytko34,1382,569662,412,246,166
570046,putin777,1251,515737,412,189,223
123636,semen25,1284,529407,412,218,194
90514,stevevx,1245,512940,412,217,195
40084,amk1,1433,589102,411,280,131
47967,firewater,2105,865378,411,246,165
1249,kadziur21,1215,499624,411,192,219
608621,mysliwy1963,1288,529586,411,211,200
19497,saywer,1496,614984,411,196,215
22684,tahiti2121,1186,487484,411,186,225
351123,ziomusiek,1249,513747,411,207,204
211513,grzybek990,1272,521840,410,212,198
367668,luqaszx,1236,506999,410,233,177
8173,lyycu,1674,686625,410,213,197
6500,michu251michu,1397,573129,410,206,204
465014,puszczamsiie,1299,532663,410,178,232
140108,strzykaweczka,1380,566188,410,230,180
570555,dmb8320g,1224,500808,409,182,227
81,em679,1390,568744,409,271,138
66913,gruszek26,1413,578025,409,242,167
79718,mare1234,1382,565314,409,257,152
56861,obrzekmozgu,1590,650333,409,225,184
379,whirrun,1551,634682,409,220,189
491552,wojciesz,1576,644839,409,241,168
175946,yebadz,1277,522390,409,189,220
629293,btc9566g,1212,494867,408,164,244
513169,grechuta06,1227,500849,408,204,204
1460,kozaczek444,1323,539822,408,228,180
485395,kszulc,1237,504712,408,187,221
623421,madklb,1302,531289,408,205,203
65,michalgalicja,1368,558256,408,202,206
544650,mwm7185,1356,553437,408,198,210
1933,oskar4,1390,567254,408,218,190
568194,pwf3691g,1217,496925,408,216,192
41443,ziba1104,1289,525974,408,222,186
265606,amazingblue,1424,579874,407,197,210
78537,kiydepyabd,1413,575319,407,200,207
162395,kmm6659g,1402,570882,407,217,190
113180,krisu170,1176,478865,407,161,246
469112,marcin89,1423,579236,407,240,167
578,marlettaa,1442,587277,407,333,74
933,warcholevic,1625,661507,407,170,237
500745,betkins,1267,514467,406,212,194
7656,bozenka1982,1392,565305,406,238,168
143694,fiat04,1367,555070,406,195,211
475357,gmg9563g,1510,613428,406,344,62
373532,gosc1,1385,562567,406,217,189
13003,jjada,1321,536585,406,193,213
122184,lubecko,1240,503806,406,183,223
2809,mckadet,1400,568545,406,197,209
216218,nmd6230g,1355,550316,406,219,187
41605,ozcriatwa,1956,794185,406,290,116
3593,quazguaz,1380,560497,406,222,184
2185,smiglo1111,1416,575129,406,228,178
2244,speedek1989,1327,539040,406,206,200
643369,wbb448g,1398,567770,406,214,192
6791,3piroman666,1213,491530,405,198,207
124853,andrzej13q,1317,533636,405,216,189
588526,blumkol,1468,594943,405,253,152
33813,dehaelek,1321,535225,405,256,149
315876,dilerkazelkow,1291,523038,405,246,159
62469,janchinho,1491,603934,405,305,100
23989,karcher9,1399,566667,405,200,205
586717,kkk2137n,1259,509903,405,193,212
269384,p0i,1358,550134,405,193,212
2708,tosskanska,1215,492421,405,185,220
17913,1maras4,1371,554032,404,215,189
26136,ancurla,1270,513483,404,181,223
479041,bajkanur,1255,507142,404,184,220
26817,boczek1v1,1590,642523,404,212,192
2004,cezm,1226,495383,404,190,214
165297,kamasutr,1370,553823,404,190,214
482073,kimdzonkun,1396,564212,404,216,188
127596,levels58,1282,518167,404,188,216
8025,marekbe21,1427,576771,404,289,115
6253,mim12376,1289,521073,404,186,218
208710,muferenti,1343,542586,404,232,172
208012,pawel1123,1271,513848,404,237,167
4607,stefan61,1259,508642,404,177,227
69633,thorrr,1319,533059,404,207,197
4443,xnorita,1433,579045,404,266,138
4471,gorawsc,1618,652088,403,215,188
680,gracwymiatac,1478,595651,403,264,139
409820,kolejorrz1922,1334,537955,403,234,169
289135,mlbrgold,1236,498468,403,218,185
291706,mqz,1531,617148,403,241,162
525262,nkn2427g,1249,503731,403,228,175
481455,nmc1423g,1342,541168,403,245,158
199358,pbn254,1245,502092,403,188,215
10846,phyzic,1347,542919,403,218,185
3440,revenfloor,1526,615171,403,194,209
92082,babiaros4112,1336,537253,402,199,203
213908,cmc2406g,1362,547710,402,279,123
41642,fedra123,1457,585958,402,262,140
158292,gorek11,1496,601654,402,238,164
342330,kenef,1482,596132,402,240,162
210578,oliwa,1128,453606,402,159,243
28723,ronaldochris,1428,574268,402,229,173
77135,slawkin,1350,542710,402,234,168
621026,spearv,1228,493700,402,226,176
783,turanturan,1240,498618,402,228,174
18820,zizi2510,1187,477498,402,188,214
364859,artweb,1269,509127,401,174,227
400631,inteligenci,2086,836604,401,168,233
467049,karmelove,1263,506585,401,228,173
331019,r4f,1381,553795,401,251,150
602800,spartaaug,1444,579353,401,171,230
570568,tomeks1260,1273,510536,401,237,164
255738,azogg,1404,561720,400,247,153
295018,mamwin,1777,710830,400,198,202
196468,ncg4116g,1275,510214,400,205,195
538225,pfkcompany,1559,623717,400,249,151
106472,player4125,1436,574660,400,186,214
536827,struzes,1301,520626,400,187,213
528819,tnp2833g,1308,523325,400,226,174
261756,agaa0o,1536,612927,399,230,169
516867,cziqita21,1213,484005,399,196,203
73555,jas17,1415,564851,399,246,153
40346,nietypowy000,1361,543252,399,253,146
11385,radekciemny,1272,507889,399,223,176
387401,zlatanibra,1131,451656,399,123,276
90791,agga3434,1361,541734,398,280,118
536998,azetka,1386,551956,398,305,93
705,barca1987,1737,691465,398,208,190
429740,eden1,1365,543579,398,224,174
2472,eop,1493,594374,398,252,146
550063,gramasla,1326,527817,398,231,167
133314,jasnymistrz,1237,492361,398,179,219
190,marcin17ah,1352,538269,398,243,155
20842,orzech1986,1248,496777,398,200,198
343,sebastian555,1375,547610,398,231,167
354005,ughh,1331,529761,398,208,190
17377,emmanuelll,1352,536755,397,167,230
859,kssryziak,1425,565727,397,189,208
65831,laptopje,1596,633914,397,221,176
279780,mirmat22,1357,539095,397,267,130
327204,swb4039g,1351,536494,397,242,155
135402,turbokamill,1330,528360,397,245,152
337527,aniulek22,1393,551695,396,239,157
171093,bodek86,1346,533208,396,227,169
306521,danusiapa,1371,543110,396,284,112
554418,kolkolkola,1456,576613,396,204,192
119556,konjan,1353,536141,396,297,99
289094,kosta1908,1321,523178,396,215,181
356775,pyton144,1218,482689,396,184,212
7761,jeffu1008,1363,538702,395,205,190
284,jerryp,1536,607073,395,219,176
16373,pacha1,1117,441483,395,138,257
97156,schumi4,1466,579166,395,299,96
197664,swiro,1287,508659,395,213,182
106833,tyskie1990,1281,506283,395,182,213
286972,bnw9691g,1200,473142,394,151,243
122041,crashcoster,1574,620260,394,197,197
563766,dsc1392g,1325,522322,394,186,208
3633,kat0lik,1417,558497,394,200,194
76620,mareck30,1344,529914,394,153,241
296013,olimpiadyl5,1320,520129,394,191,203
86595,psilotopsida,1269,500294,394,201,193
1965,wolakq,1247,491474,394,189,205
588592,wroztadeusz,1306,514867,394,195,199
12511,allkarin,1256,493947,393,185,208
15097,darekpl,1383,543639,393,220,173
46433,gemona,1362,535334,393,213,180
226082,jack0daniels,1736,682391,393,258,135
387018,nfb591g,1314,516437,393,238,155
634751,ppw3463g,1125,442231,393,113,280
3701,sowerro,1282,503986,393,191,202
114693,toma1573,1555,611363,393,243,150
363186,tomula78,1268,498656,393,201,192
8764,tukan1989,1243,488720,393,201,192
33231,turtymas,1327,521845,393,209,184
3635,volowaty,1898,745973,393,234,159
438670,wck6589g,1375,540609,393,261,132
596388,damian66,1321,518043,392,257,135
396260,fmt8218g,1360,533509,392,225,167
204520,kochamencie,1758,689435,392,229,163
130528,pedofilloo,1332,522305,392,204,188
11870,yediknight,1459,572275,392,205,187
616852,atyk,1405,549468,391,225,166
304443,cgp1678g,1357,530681,391,174,217
45198,ginterka,1287,503487,391,227,164
343064,kmm4605g,1322,517167,391,216,175
119175,mig87,1354,529506,391,133,258
217227,rav55,1330,520381,391,185,206
156579,veyr,1297,507210,391,233,158
73724,wolnydzien,1375,537665,391,202,189
359067,exkrex,1246,486215,390,170,220
50766,ka1997,1344,524495,390,211,179
20,magdaoa,1233,480916,390,163,227
207879,ptk6515g,1299,506725,390,188,202
93034,sledziu76,1544,602506,390,227,163
589555,wmp967g,1259,491194,390,208,182
117037,adamm5,1385,538772,389,231,158
448898,bartkoooo,1373,534256,389,274,115
43677,bomba7,1588,617954,389,166,223
527544,bwk4685g,1409,548320,389,271,118
540915,cmt8864g,1373,534243,389,212,177
174150,djsmierc,1498,582799,389,254,135
127479,nasolo,1434,557878,389,224,165
54016,reporterplayer,1959,762381,389,171,218
354383,ric0,1500,583854,389,253,136
618603,tcc5679g,1273,495268,389,200,189
34952,triumfator123,1359,529025,389,182,207
6687,vboer,1892,736072,389,274,115
70188,europe0,1491,578881,388,222,166
549719,expok86,1224,475187,388,171,217
33068,nipoterek,1318,511479,388,186,202
199201,spil,1402,544066,388,217,171
36543,strongblast,1537,596694,388,196,192
11230,tartale,1796,696880,388,192,196
82132,verktoy,1389,539019,388,211,177
10275,4move,1661,643111,387,209,178
156302,bsm9345g,1218,471576,387,201,186
461681,czakilaki,1280,495494,387,228,159
90312,damuryne,1343,519979,387,178,209
90636,fajansik,1411,546376,387,189,198
165709,hottunacom,1408,545181,387,240,147
158367,mbp8452,1386,536617,387,151,236
421,siergiej1985,1130,437526,387,129,258
108820,10zl,1400,540773,386,181,205
236118,acn1,1256,484911,386,167,219
216348,bamboszmleko,1306,504345,386,152,234
73429,bartek2920,1247,481667,386,223,163
833,djdawidex,1421,548864,386,213,173
34095,hugunio,1254,484323,386,180,206
656055,marsjal,1464,565117,386,245,141
4754,mirekb22,1414,545851,386,257,129
165330,szejmous,1284,495838,386,266,120
503432,zagracie,1624,627004,386,236,150
191940,bartosz0111,1276,491486,385,187,198
565894,bizon0,1289,496604,385,176,209
336868,cmg9232g,1219,469372,385,171,214
259504,djdziadek,1175,452527,385,137,248
87775,eloelo5dwa0,1443,555761,385,193,192
1406,enzorr,1413,544374,385,296,89
46858,fwt7088g,1864,717939,385,240,145
151406,jopines,1540,593153,385,331,54
12242,kowalgwo,1292,497711,385,206,179
663069,pilkarzz,1284,494543,385,197,188
273609,sbc9872g,1243,478815,385,190,195
137777,tomaskoru27,1545,595016,385,233,152
391772,bajac,1353,519675,384,190,194
615356,ebi997,1167,448350,384,149,235
483714,epoy,1324,508634,384,206,178
7468,gallaxis,1296,497674,384,249,135
109082,jamznammyslit,1360,522608,384,197,187
73114,piotrekd1122,1278,491134,384,171,213
392556,qpi,1791,688007,384,220,164
751,ripon,1257,482867,384,196,188
125139,wmk3773,1486,570835,384,227,157
241622,czarnula2015,1181,452585,383,160,223
260372,gladki7,1264,484150,383,195,188
231,harnasssss,1332,510326,383,207,176
468649,majne1,1170,448471,383,169,214
28674,marsjak13,1581,605729,383,279,104
603,nighel,1212,464328,383,226,157
26880,qwsxza,1445,553473,383,210,173
126808,tracerds12,1461,559863,383,274,109
616136,wdm3620g,1356,519701,383,207,176
394508,weed340,1287,493197,383,193,190
349967,wergol1992,1241,475381,383,165,218
40747,xkasia15x,1272,487279,383,198,185
23069,bootes,1690,645957,382,206,176
236771,colorwiosny,1395,532942,382,217,165
94118,david0,1898,725305,382,228,154
77209,evelka89,1247,476473,382,228,154
73958,jaca941,1418,541825,382,219,163
92866,kanaji1,1242,474592,382,178,204
113450,kwaku9,1580,603676,382,175,207
610110,mfk4663,1197,457520,382,193,189
44194,pawelg2006,1367,522565,382,193,189
53681,dominik8587,1277,486602,381,148,233
8118,jagodzina23,1294,493088,381,187,194
51521,krejzol23,1154,440019,381,128,253
32556,krychaycha,1474,561728,381,263,118
241635,kwg9756g,1419,540926,381,210,171
2295,mlodyzaq,1393,531024,381,254,127
585195,natalkka71,1201,457721,381,203,178
406475,pom44,1510,575342,381,231,150
17363,sawid,1522,579975,381,209,172
350161,szkutnik09,1364,519697,381,280,101
565886,zgrubejrury,1507,574310,381,214,167
254230,0604,1661,631546,380,204,176
582854,baran1989,1296,492583,380,178,202
353942,bbb1490g,1276,484942,380,193,187
101247,bezimienna100,1283,487614,380,212,168
132958,horrorcor,1512,574907,380,183,197
74389,koman17,1261,479378,380,197,183
369733,msn3231g,1362,517590,380,230,150
4052,parawanek11,1230,467547,380,172,208
7928,petersimon,1359,516556,380,153,227
22011,pokazcoumiesz,1413,536971,380,232,148
545352,szmit,1479,562196,380,169,211
126485,tachometro,1666,633254,380,236,144
96024,taktyka,1788,679694,380,244,136
615325,wnbolenka,1307,496734,380,228,152
32650,666szc666,1290,489061,379,209,170
344187,estelak,1314,498114,379,225,154
256208,kenetaudi1984,1389,526677,379,226,153
47767,klaudunia2103,1222,463199,379,191,188
21859,kraska007,1558,590518,379,339,40
399964,l0ck,1809,685893,379,235,144
236011,natalia6344,1253,475155,379,231,148
162402,npc721g,1287,487991,379,236,143
108130,potrekf,1199,454790,379,146,233
530315,sambo386,1269,481041,379,200,179
37969,searem,1971,747296,379,203,176
208036,tusiera,1072,406411,379,97,282
6581,walduc,1235,468395,379,177,202
4329,albea04,1422,537745,378,155,223
159060,bluetante,1717,649210,378,238,140
225572,dopajasiuiii,1400,529358,378,189,189
34888,maleya,1678,634327,378,165,213
14626,maxbyniek,1282,484910,378,184,194
402969,mng8957,1285,485875,378,224,154
222253,myszka11111,1163,439982,378,151,227
117974,nonus25,1389,525400,378,254,124
4123,outs1de,1414,534637,378,224,154
3045,rubens995,1422,537519,378,219,159
571623,zulawinski,1342,507632,378,215,163
44633,achwen,1397,526915,377,207,170
84599,alchemikd,1398,527164,377,205,172
33020,bijmniewkask,1468,553451,377,170,207
648537,calllnoste,1313,495232,377,185,192
14012,chorjak89,1499,565188,377,228,149
241,decuz93,1324,499500,377,177,200
78084,lukaszgut1,1321,498245,377,195,182
82618,lvlalylvliki,1925,725793,377,245,132
2519,magdasolec,1341,505696,377,175,202
531810,petyrbaelish,1649,621945,377,246,131
89557,turkusowy1,1300,490381,377,215,162
551160,abrarakutafix,1324,497967,376,268,108
68842,agst,1392,523549,376,190,186
265891,arcziss,1184,445202,376,177,199
418263,babartek,1386,521401,376,280,96
467927,bbb4059g,1335,502329,376,208,168
652071,bbf4685g,1384,520553,376,239,137
1595,brook84,1373,516552,376,195,181
78744,cinio777,1839,691788,376,213,163
482,dyrywacze,1511,568175,376,181,195
140538,fanzakiu,1636,615159,376,205,171
29594,gracz02,1315,494638,376,234,142
179502,kozak1234on,1151,432974,376,141,235
237444,wiesiek456,1192,448233,376,175,201
213088,csn3723g,1252,469614,375,164,211
2428,dolorcelos,1359,509656,375,208,167
286039,fdt6995g,1171,439208,375,148,227
512332,gbb4100g,1185,444476,375,141,234
57763,judi1987,1465,549422,375,190,185
196454,karpik1968,1213,455082,375,179,196
475519,nbk874g,1387,520419,375,282,93
8382,tompaj10,998,374537,375,81,294
85271,zxcvbnm000,2422,908450,375,205,170
29893,bialajazda,1265,473476,374,178,196
120311,cysiu7,1385,518064,374,224,150
543962,deegustator,1826,682997,374,207,167
269336,endrjugolotaa,1171,438160,374,151,223
387866,kongratulatio,1250,467552,374,224,150
73888,mamtocochce,1137,425531,374,148,226
45055,15o0sto9oo,1470,548561,373,189,184
30467,daro80,1357,506249,373,176,197
280563,doubleoseven,1306,487357,373,221,152
44497,dzadza0404,1224,456766,373,165,208
211311,jestemslawny,1665,621259,373,195,178
282019,kamaka7811,1279,477382,373,200,173
12754,komputronic,1461,545085,373,262,111
12710,lisowczyk321,1301,485391,373,184,189
138874,maras212,1241,463088,373,176,197
554112,mcs9836g,1417,528758,373,180,193
31544,mefiu2k,1244,464370,373,148,225
144777,osttry7,1272,474553,373,174,199
10158,petrolek,1253,467479,373,202,171
223346,sasukeuchiha,1250,466258,373,173,200
412584,tomasgrupas,1287,480221,373,209,164
160,valdi7777,1286,479881,373,188,185
496582,wwt5496g,1306,487459,373,219,154
87020,zywi17,1278,476826,373,181,192
49755,allstart,1585,589974,372,186,186
576293,bbp8140g,1356,504721,372,143,229
537458,cds2304g,1383,514704,372,229,143
22123,fabrykakredek,1512,562493,372,193,179
561200,fizol22,1801,670277,372,235,137
9550,leszko36,1391,517495,372,226,146
16584,misqkrk,1290,480158,372,216,156
112501,sarty33,1607,597978,372,305,67
239092,sfd8531g,1648,613262,372,212,160
1495,sstachuu,1364,507568,372,192,180
326241,twofox,1385,515553,372,224,148
138840,bedson,1318,489209,371,210,161
169394,damian2507,1339,497051,371,172,199
250204,fpk2151g,1333,494621,371,225,146
556436,mateuszur,1313,487146,371,221,150
420755,mii222,1274,472675,371,191,180
279832,pom13,1481,549609,371,198,173
519579,pwm1986g,1341,497755,371,189,182
60426,robert223,1318,489345,371,153,218
408541,wfc3069g,1388,515302,371,245,126
63529,eldorado225,1258,465766,370,176,194
370775,malamigota,1554,575205,370,201,169
274322,mfc1508g,1196,442679,370,162,208
363961,ni3znany,1576,583273,370,203,167
606805,piwopiwo,1508,557989,370,207,163
1108,rxfyps,1562,577994,370,204,166
3626,skorup15,1572,581890,370,231,139
8923,5zoom,1317,486241,369,222,147
230872,comemylady,1878,693229,369,244,125
31715,dzihad9,1279,472002,369,174,195
12604,espero44,1209,446181,369,141,228
59502,gregorianczyk,1365,503860,369,201,168
131350,krolalbanii93,1280,472470,369,163,206
155475,kss4672g,1287,474991,369,226,143
4024,lisu8,1317,486264,369,162,207
320761,mother4,1459,538731,369,241,128
595714,mtw6396,1338,493978,369,187,182
6171,nowy216,1950,719601,369,180,189
407244,basia1917,1206,444093,368,213,155
401398,bg50,1194,439515,368,134,234
359177,cidinc,1431,526854,368,174,194
514271,dng6206g,1443,531143,368,229,139
15411,kasiulka6165,1347,495764,368,178,190
125375,mangyang,1933,711596,368,249,119
2640,marian30,1333,490663,368,180,188
446048,matts3108,1349,496454,368,233,135
55065,mistery123,1313,483234,368,175,193
396738,propagacja,1825,671695,368,233,135
99544,przemek2021,1377,506858,368,285,83
192035,rayann,1887,694746,368,240,128
4467,smokeweed,1343,494460,368,226,142
279683,stonogazbys,1229,452614,368,166,202
397251,arrivederci,1182,434050,367,147,220
53346,ckm8537g,1299,476798,367,198,169
647551,czesiu777,1303,478406,367,188,179
476135,dst2528g,1390,510187,367,161,206
547163,leprous,1748,641796,367,253,114
654828,nkc6079g,1165,427818,367,136,231
162770,peterweter,1384,508255,367,187,180
730,sqniarz,1507,553170,367,184,183
229914,uczessiegrac,1321,484831,367,168,199
157600,wwd1597g,1349,495425,367,213,154
985,333duo,1914,700698,366,174,192
37718,balwan,2055,752470,366,290,76
99074,cristiano1111,1410,516208,366,221,145
375690,dds9040g,1372,502262,366,245,121
396966,dfp2363g,1338,489739,366,208,158
126984,donciak,1147,419991,366,131,235
496984,dtd5325g,1379,505035,366,197,169
236875,dwn1981g,1146,419560,366,132,234
356587,exkrex1,1166,427002,366,154,212
590547,fwt1853,1332,487560,366,187,179
55917,grysiuu,1153,422235,366,142,224
9028,jaksiewtogro,1232,451056,366,155,211
19707,karoll9,1351,494478,366,202,164
519189,kulidlub,1230,450362,366,161,205
35624,lea147,1358,497262,366,252,114
9667,manchesterios,1422,520687,366,205,161
10187,rafalmaciej2004,1532,560794,366,232,134
368288,robybaggio,1373,502555,366,165,201
116604,25natalka2,1368,499406,365,194,171
536134,calcio,1627,593868,365,250,115
630218,dna1987,1544,563798,365,171,194
6644,grajmy92,1567,572163,365,199,166
488553,ivyclub,1195,436250,365,164,201
55918,kochammajke,1241,453272,365,222,143
155901,konjed4,1602,584915,365,223,142
617012,led1,1371,500581,365,156,209
63057,marek1505,1133,413877,365,137,228
123857,mariot9,1267,462541,365,179,186
58012,mikikoli,1273,464982,365,165,200
2422,padre2,1526,557162,365,218,147
97281,s13m4,2453,895563,365,248,117
212769,tft5355g,1341,489757,365,175,190
1532,wojtek0486,1424,520000,365,179,186
242210,wsm7629g,1416,516973,365,218,147
63112,basia22,1150,418726,364,140,224
10032,bieniek1991,1170,425992,364,142,222
113724,bostwo16,1189,432960,364,187,177
143548,cmn8814g,1527,556141,364,183,181
7578,dkowal,1301,473593,364,204,160
368879,ghostrider33,1333,485534,364,250,114
442,kliczko23,1435,522517,364,250,114
190217,nff191g,1365,497217,364,202,162
607837,sala212,1541,561026,364,218,146
508068,sdt3310g,1414,514911,364,165,199
38962,tomko11,1362,495822,364,216,148
30164,urokcygana,1496,544563,364,168,196
9726,kachnaaaaa,1298,471451,363,190,173
267263,mbf7084g,1359,493530,363,255,108
367182,michalskladam,1381,501356,363,226,137
70162,oskaros20,1418,515042,363,221,142
445225,pepik32,1239,449804,363,190,173
219449,pgp4935g,1330,482844,363,226,137
387980,plazma1987,1580,573839,363,199,164
242003,robfly,1350,490404,363,189,174
122769,sebak87,1422,516186,363,221,142
407811,wgk6417g,1233,447768,363,183,180
110268,wnp6738,1406,510431,363,243,120
268714,aniolon,1281,463915,362,197,165
18058,batek,1415,512345,362,186,176
228135,danison,1188,430372,362,146,216
451940,dkdk27,1503,544257,362,194,168
38894,elvis666,1343,486450,362,194,168
1708,grantor,1585,573788,362,177,185
18695,kalupa117,1163,421275,362,141,221
349461,naataalijkaa,1297,469749,362,203,159
69432,petardos,1572,569244,362,208,154
214138,puchatykubus,1171,423950,362,178,184
576952,seba00demon,1268,459026,362,175,187
45871,warunia,1912,692223,362,242,120
414326,xb0x0ne,1763,638486,362,208,154
1355,jana,1261,455561,361,167,194
352265,kcb9314g,1352,488076,361,255,106
585194,pszemko17,1177,425180,361,167,194
142009,wolnaiwona,1672,603685,361,267,94
2245,andrew9109,1554,559496,360,192,168
121841,booojka,1308,470929,360,215,145
239734,corteza,1566,564049,360,182,178
369479,dwt6207g,1347,484934,360,193,167
101295,henryk1990,1295,466547,360,199,161
18110,konradekek,1669,601036,360,179,181
265004,qazplm9,1609,579474,360,184,176
11339,t0n,1687,607329,360,219,141
50383,tkn0562,1659,597501,360,219,141
230679,valdas89,1272,458217,360,192,168
199445,xfuse,1594,573993,360,297,63
126983,bananodajny,1250,448798,359,231,128
575178,cdw1570g,1121,402723,359,97,262
115333,dcp4200,1154,414587,359,139,220
9804,kolorowy0077,1233,442999,359,127,232
69708,penior1,1335,479289,359,187,172
341829,ptb151g,1360,488591,359,219,140
103640,siurrrek,1348,484228,359,188,171
135777,szarikdar12,1304,468475,359,183,176
263101,andrzej9999,1239,443684,358,176,182
7829,ardnaxelaa,1368,489817,358,223,135
579771,cmw351g,1332,476909,358,243,115
42332,gol999,1294,463595,358,168,190
224009,kinposto,1325,474438,358,189,169
568544,mtm201g,1356,485514,358,239,119
59934,piter061,1379,494001,358,170,188
87594,pittdirk,1427,511070,358,199,159
50136,qazar,1603,574018,358,189,169
275268,qdwiert,1272,455437,358,203,155
252755,tfs1338g,1280,458276,358,187,171
124765,bartekrk87,1253,447649,357,158,199
405264,chcedorodziny,1350,482239,357,165,192
400475,czopekw,1614,576358,357,280,77
412883,fkf578g,1366,487893,357,195,162
87156,frytka1927,1440,514195,357,233,124
19306,igor61,1321,471663,357,192,165
98100,indilaveris,1595,569570,357,207,150
584160,klosik4,1319,471006,357,216,141
545683,lypaczu,1155,412469,357,108,249
2230,magmigotka,1266,452061,357,206,151
47350,major89ns,1408,502817,357,214,143
205890,maro10x,1303,465392,357,195,162
318988,ndg6556g,1301,464592,357,184,173
42779,pawcio241,1400,499833,357,180,177
12109,shark24,1384,494195,357,189,168
284413,zagusia,1190,424976,357,139,218
257753,bdk9792g,1271,452831,356,201,155
537925,cmg24m,1480,527087,356,183,173
199166,karminadel,1466,521935,356,218,138
10655,klapciasty,1334,475046,356,200,156
1601,nowy35wawa,1378,490703,356,185,171
445186,pkt4196g,1370,487962,356,219,137
386495,roxiab,1205,429021,356,178,178
53942,ceha23,1357,481855,355,232,123
84772,hirokihime,1237,439311,355,145,210
6941,karwan123,1168,414652,355,127,228
31090,lipa6673,1553,551403,355,216,139
298958,nietwojabajka,1380,490191,355,269,86
317400,pdd5488g,1308,464455,355,165,190
74856,rafal0611,1413,501911,355,220,135
128616,smoczyzabojca,1463,519642,355,196,159
221479,tasior35,1193,423594,355,164,191
191232,tsw5491g,1122,398339,355,112,243
623813,wmb653g,1199,425788,355,156,199
1646,barti65,1189,421083,354,139,215
277031,gdw6911,1224,433333,354,165,189
21,kin2,1514,536146,354,203,151
216950,optuk,1590,563045,354,241,113
443267,pmc9050g,1462,517769,354,241,113
4942,rafal7pol,1266,448190,354,181,173
186391,116d,1465,517448,353,197,156
50655,badraven,1275,450366,353,157,196
116231,guti,2392,844713,353,182,171
619902,isaacofuluru,1268,447893,353,163,190
92615,maxio11,1372,484562,353,264,89
4179,michu3003,1344,474683,353,180,173
441,ouki,1334,471105,353,215,138
221328,stanislaw1900,1300,458967,353,210,143
403687,wlkp,1049,370411,353,91,262
2253,3jkups3klej,2505,881803,352,208,144
521810,bsk2295g,1370,482573,352,222,130
29274,leformol,1086,382406,352,104,248
55804,mojemarzenia5,1109,390455,352,117,235
555919,nike94,1669,587799,352,211,141
208932,pfp149g,1228,432510,352,178,174
33626,rejut,1427,502592,352,183,169
560747,sedersed,1378,485093,352,226,126
785,slice00,1432,504395,352,165,187
227430,tartak,1358,478184,352,234,118
116823,toxarion,1368,481703,352,145,207
77726,andrzejlencew,2165,760042,351,202,149
411572,barteekkk,1276,448138,351,184,167
86585,fnw3536,1322,464119,351,230,121
41563,leeooon,1296,454952,351,204,147
496325,lukaszs89,1306,458477,351,194,157
871,nowicjuszslim,1694,594706,351,191,160
988,sulej1,1304,457810,351,187,164
497202,tnn4484g,1360,477643,351,238,113
73091,wac0410,1605,563441,351,186,165
338487,650ci,1516,530772,350,171,179
510779,8slawek5,1369,479355,350,244,106
50856,aleks16,1216,425799,350,171,179
412888,andintpro,1321,462501,350,203,147
17664,dawn82,1606,562300,350,151,199
74745,designe,1449,507154,350,175,175
31942,echo352,1382,484009,350,173,177
5785,fantur,1372,480269,350,207,143
296791,fudx,1104,386578,350,112,238
376146,kruq2,1776,621692,350,210,140
43589,marketch,1155,404254,350,110,240
231582,mrlukaszu,1535,537341,350,305,45
214486,noshad,1204,421617,350,155,195
101400,tomek3332,1220,427000,350,152,198
7399,akukl0n,1471,513487,349,166,183
443532,borupl,1507,526230,349,190,159
514401,cnn1390g,1286,448994,349,171,178
34496,dumdum31,1331,464733,349,173,176
142110,fssd,1370,478189,349,239,110
196619,gryzoncy,1319,460510,349,198,151
12578,kax,1519,530302,349,186,163
656459,kulka1357,1176,410703,349,166,183
28180,kurkanajajko5,1382,482607,349,162,187
73585,melania20,1094,382095,349,109,240
590505,mwn7814g,1296,452314,349,209,140
167390,nikaki,1682,587312,349,192,157
3037,pelsonnn,1314,458913,349,226,123
95508,telewizor20,1526,532862,349,182,167
467951,666lucyffer,1341,466749,348,186,162
542492,cmw4111,1325,461212,348,185,163
493040,fnn3280g,1441,501507,348,190,158
44403,garfildo2323,1396,485987,348,242,106
108730,goral2002,1202,418488,348,159,189
323478,hoogans,1457,507158,348,171,177
56163,jarek114,1184,412288,348,177,171
2657,konik009,1369,476690,348,182,166
596225,kres23,1062,369723,348,97,251
125213,maxprzyst,1262,439369,348,155,193
220058,miszczu111,1590,553595,348,240,108
99400,pocztowiec,1310,455959,348,187,161
482541,retlaw77,1180,410981,348,142,206
3688,szymo93,1325,461371,348,182,166
50836,ulwernysa,1383,481609,348,189,159
378858,2017r,1473,511442,347,208,139
6448,adamil,1105,383487,347,127,220
3128,cmynec,1416,491618,347,173,174
370248,dnc4578g,1264,438870,347,155,192
368124,fpt6372g,1252,434629,347,188,159
480480,gdw9575g,1362,472930,347,218,129
8704,karolcia1224,1204,417963,347,138,209
394486,kondi910,1393,483579,347,206,141
133505,lol00lol,2514,872600,347,212,135
269855,mir104,1527,529942,347,209,138
118242,monika122,1345,466886,347,156,191
141529,papeq,1385,480884,347,206,141
304320,psm6026g,1332,462385,347,185,162
29651,wdk2649,1107,384414,347,108,239
83328,werka4040,1296,450016,347,221,126
8448,barylka111,1344,465045,346,162,184
6898,budovvlaniec,1407,487079,346,149,197
13584,cnotunia,1308,452575,346,138,208
91168,coconadmial,1526,528176,346,199,147
651654,dbw2303g,1586,549011,346,266,80
495437,footballclub,1924,665712,346,237,109
282299,gnw446,1200,415438,346,185,161
44023,panarek,1355,469042,346,152,194
180642,piratzbaltyku,1392,481958,346,246,100
607270,scg8345g,1273,440636,346,197,149
2249,tomeks80,1210,418907,346,132,214
53618,yessin,1305,451706,346,158,188
107699,a4k7,1381,476451,345,196,149
49011,bonzo98,1197,413008,345,149,196
230759,carls,1225,422736,345,150,195
334194,kimdzong,1731,597357,345,187,158
187697,maroku,1380,476313,345,214,131
368287,nmt7158g,1197,413043,345,153,192
65327,onaonaona18,1415,488197,345,162,183
819,rolsrols,1466,505875,345,210,135
187780,xxxl123,1291,445555,345,213,132
458573,annxzv,1219,419432,344,167,177
111609,jasik1985,1458,501654,344,202,142
3650,lissek,1387,477134,344,164,180
190542,maldar,1417,487788,344,180,164
337806,mbw659g,1326,456273,344,155,189
153517,mzmms,1378,474243,344,207,137
239985,rycerzkkk,1156,397956,344,130,214
136460,speed96,1419,488396,344,169,175
639458,tbf3548g,1290,444057,344,192,152
252,wasylno,1240,426612,344,148,196
65724,woj87,1264,435006,344,161,183
983,0niechcemisie,1591,545884,343,180,163
428138,ctm9044,1231,422560,343,180,163
208786,d3utschland,1997,685116,343,243,100
612665,ddb9451g,1306,448206,343,187,156
489769,dsm8220g,1341,460093,343,232,111
225050,dwg1621,1327,455168,343,188,155
236890,fts7597g,1124,385642,343,129,214
14443,gnojarz,1352,463872,343,139,204
340141,gsf6684g,1541,528747,343,237,106
8796,hubercik6900,1386,475630,343,191,152
24394,jablonlowicz,1347,462196,343,186,157
54559,karolinka126,1189,407827,343,119,224
543928,pralinkaaaa,1416,485923,343,234,109
300643,prograczkamil,1311,449708,343,159,184
531245,pwf5266g,1296,444842,343,185,158
277675,swt1985g,1274,437021,343,200,143
3892,wikiol,1232,422694,343,158,185
175559,wpieniacz,1847,633633,343,203,140
17867,wygrammecz,1970,675776,343,257,86
2990,xbabier,2025,694877,343,190,153
442532,infp,1591,544368,342,208,134
23924,kapsel2203,1336,457147,342,201,141
555943,lamawsypialni,1447,494896,342,201,141
1469,perkins007,1389,475314,342,192,150
116451,pewniewygrasz,1467,501760,342,184,158
530177,skyres,1314,449646,342,181,161
14953,bogdann1980,1389,473956,341,174,167
3699,cin7,1467,500428,341,275,66
373363,karsonpl,1236,421713,341,178,163
1573,sulikoow,1832,624962,341,236,105
79870,szybki84,1646,561600,341,193,148
27157,virulentx,1402,478139,341,165,176
434928,vojti,1192,406623,341,150,191
1172,zjawakurnikow,1323,451210,341,154,187
44609,zlosliwyczart,1615,550841,341,179,162
594339,4sergioramos4,1403,477184,340,149,191
3549,arnold9999,1459,496257,340,215,125
13366,czako89,1474,501212,340,213,127
244278,ffff,1459,496193,340,201,139
198986,fiat126pe,1458,495901,340,220,120
102303,gabjus,1329,452138,340,214,126
104331,goszkagoszka,1241,422195,340,111,229
325555,horsch,1492,507472,340,218,122
425004,kamcio747,1284,436819,340,179,161
4188,lewiatan666,1431,486563,340,184,156
26451,lukaszm5,1290,438714,340,160,180
319109,lukskajwalker,1722,585626,340,203,137
185458,malawredota12,1199,407722,340,136,204
192500,mike999,1502,510915,340,200,140
520,nie1mam2nicku,1191,405235,340,134,206
9409,niegodny,1284,436583,340,164,176
12231,pinnex,1587,539819,340,195,145
1295,szybki88,1310,445420,340,148,192
41982,trzeszczyk,1419,482627,340,196,144
98418,zajek76,1287,437582,340,176,164
15857,1988dawid,1256,425955,339,143,196
648083,1demoniasty,1249,423516,339,177,162
62019,2341,1638,555520,339,190,149
213745,amat0rgry,1712,580546,339,210,129
73936,bobek024,1326,449608,339,168,171
91655,cormax,1231,417314,339,168,171
117566,marek1222,1100,373139,339,100,239
602003,marekinpoland,1246,422563,339,173,166
521074,mws8824g,1426,483746,339,194,145
16187,piotr8989,1289,437283,339,195,144
50401,rolu777,1538,521609,339,187,152
365474,skb2831g,1324,448975,339,190,149
126548,vvjk,1791,607247,339,235,104
218937,cytrynka51,1217,411618,338,205,133
256097,gotfather,1410,476748,338,180,158
1450,justyna0506,1321,446654,338,214,124
573781,kfn6229g,1539,520399,338,217,121
120616,lukaku07,1300,439419,338,147,191
70939,luuuu,1693,572348,338,189,149
8686,marco1982,1303,440653,338,169,169
144424,mwc8938g,1380,466597,338,198,140
67737,patlyk13,1169,395385,338,155,183
601011,zdzisiuuu,1262,426778,338,193,145
137861,zikerofficial,1603,542074,338,200,138
25251,zoladek24,1110,375424,338,81,257
17809,bagio,1489,502008,337,276,61
1000,budzik1234,1374,463262,337,207,130
477336,gnp3832g,1511,509425,337,210,127
478842,graczyk83,1380,465260,337,172,165
262364,just18,1151,388094,337,124,213
26210,legionnaire90,1301,438485,337,168,169
8746,mojka44,1419,478325,337,269,68
81022,mortttteeeek,1376,463968,337,230,107
543430,oldzixx,1232,415281,337,163,174
3113,piec9559,1264,426119,337,160,177
48951,pijanyszef,1306,440390,337,132,205
183,rogalik266,1392,469399,337,253,84
577,star28,1506,507540,337,209,128
482745,wgw2266g,1461,492474,337,168,169
541061,baron33,1227,412468,336,175,161
475760,bdn608g,1284,431677,336,168,168
197943,bochomaz,1429,480365,336,208,128
126,djmlodyy,1390,467231,336,167,169
161973,fangier,1381,464335,336,187,149
20247,kak00tbg,1418,476773,336,203,133
386423,kyus,1336,449125,336,162,174
265348,ogiensmoczy,1438,483457,336,184,152
122,piachu1986,1298,436266,336,144,192
18359,picusia,1383,464860,336,151,185
6457,qiotrr,1363,458030,336,183,153
90754,rett0,1215,408302,336,193,143
69643,rms89gt,1242,417451,336,202,134
23250,robaczkiwymoje,1791,601936,336,155,181
50452,rolbas1,1380,463984,336,208,128
19404,tupak2012,1708,574218,336,186,150
101946,turowiec,1637,550321,336,193,143
16712,beny12345678,1327,444645,335,194,141
100626,dobryjestem12,2188,733066,335,170,165
448139,gsn2094g,1214,406896,335,155,180
208282,jasko282,1497,501559,335,239,96
30187,karril,1372,459777,335,182,153
29286,kryszak11,1244,416745,335,236,99
91764,lukimiszczu,1308,438410,335,227,108
69642,misias81,1169,391920,335,134,201
641626,pantera07,1270,425644,335,157,178
191811,piotrekstw,1285,430584,335,169,166
55771,piter772,1313,439862,335,168,167
291848,pnb3199g,1259,421828,335,174,161
265140,saguaro1234,1112,372611,335,106,229
116466,siles,1754,587663,335,223,112
7410,traktorek46,1386,464601,335,171,164
257309,ara1974,1193,398561,334,133,201
336934,cykicwa,1285,429296,334,180,154
297930,ericdraven,1308,436901,334,180,154
204914,gkb191g,1488,497163,334,254,80
160726,kopytko97,1309,437487,334,146,188
16315,mtx009,1566,523097,334,178,156
88457,nedzarzyk,1352,451658,334,195,139
76193,pawelek12345,1228,410409,334,135,199
20993,rymar21,1350,451188,334,178,156
7358,sansol,1343,448661,334,179,155
126802,skortom,1547,517001,334,207,127
98142,songovu,1464,489135,334,200,134
475907,wfg8405g,1388,463863,334,189,145
202972,alvaro83,1428,475683,333,201,132
345296,ania123,1172,390475,333,127,206
467961,anikami,1734,577635,333,235,98
255560,dgn7692,1423,474094,333,227,106
184772,fks1498g,1402,466888,333,157,176
38808,golomptygrysi,1220,406463,333,153,180
67409,kak00iceman,1468,488891,333,188,145
104052,klementyna34,1352,450355,333,252,81
326556,maessencials,1197,398721,333,111,222
224489,mefinho,1388,462232,333,184,149
45459,orbit,1679,559213,333,222,111
120964,radek1900,1219,406190,333,154,179
645526,tylkopassat,1354,451119,333,194,139
437058,veronissia,1214,404351,333,134,199
501704,xardas,1250,416427,333,132,201
33644,dami141,1270,421772,332,162,170
5924,hellg,1757,583428,332,236,96
66355,kali018,1391,462077,332,185,147
484537,kmn3295g,1206,400601,332,150,182
536211,ktw3926g,1367,453933,332,199,133
7340,michaelo1,1475,489918,332,167,165
103683,mouliaa,1720,571122,332,201,131
1173,nocnyxduszek,1362,452405,332,182,150
4484,octans,2076,689237,332,202,130
305379,wodabrzozowa,1452,482120,332,283,49
350949,dgw1499g,1229,407120,331,144,187
61347,dwooo,1211,401144,331,146,185
336915,ernestoguevar,1223,404986,331,172,159
22868,farmidona,1514,501244,331,182,149
77123,halamadrid26,1334,441557,331,176,155
2426,hipis,1293,428253,331,175,156
417282,konrradek,1241,411015,331,148,183
1878,malylks,1299,430182,331,169,162
28523,pilka234,1329,440190,331,242,89
147051,swn5631g,1613,534226,331,250,81
211250,xxxx113,1602,530511,331,181,150
495872,adix360,1258,415449,330,171,159
6630,cpuhdd,1333,439908,330,176,154
251,czoorny85,1284,423923,330,187,143
76883,exo89,1482,489206,330,145,185
38745,kierko1982,1262,416515,330,132,198
561,klikabang,1664,549399,330,162,168
501991,krwawamogila,1131,373321,330,117,213
82240,mruczek17,1329,438746,330,218,112
7162,sam998,1161,383429,330,115,215
37288,sebga,1159,382740,330,116,214
59764,zakochany7,1385,457100,330,161,169
65283,8kamil6,1273,418945,329,155,174
1846,arkkoc,1324,435800,329,214,115
469692,blondasek97,1408,463302,329,259,70
542784,cinek32krk,1247,410360,329,132,197
1488,dokolyski1987,1444,475381,329,213,116
558215,drops12,1487,489373,329,176,153
41543,edrien,1721,566408,329,168,161
165331,fsb5750,1123,369672,329,96,233
613638,gifcio,1301,428181,329,182,147
6521,kokapr2,1329,437372,329,180,149
293606,nocnykasanowa,1545,508452,329,241,88
48566,orantka,1136,373797,329,115,214
134237,pii,727,239316,329,109,220
82242,wojtunio34,1117,367627,329,108,221
198196,wtp1618g,1201,395409,329,150,179
15805,19siwek20,1222,400821,328,170,158
64132,agnes132,1393,456962,328,215,113
578759,banan25,1492,489689,328,153,175
63347,bandast,1200,393872,328,165,163
568791,bedeczerwonym,1455,477343,328,193,135
79180,beli997,1163,381555,328,111,217
79836,geoterm,1332,437192,328,149,179
199813,haifi,1265,415209,328,208,120
553584,jadro,1681,551592,328,167,161
18831,jafarski,1478,484853,328,195,133
666956,kurnikgry,1218,399669,328,162,166
270169,luxmario,1305,428364,328,180,148
562591,ngf2034g,1325,434766,328,200,128
73508,pan9,1327,435329,328,192,136
117,pierwszagra27,1199,393343,328,115,213
137578,qim,754,247443,328,60,268
125934,ttk6236g,1118,366879,328,104,224
490618,wgp3946g,1449,475439,328,236,92
593261,boss7,1490,487519,327,203,124
500698,dst1991g,1802,589429,327,200,127
398734,ksf2961g,1242,406289,327,149,178
74665,kuri18,1230,402359,327,147,180
343486,ptd6238g,1492,487976,327,154,173
90303,robybaggio10,1330,435143,327,164,163
211983,zakowereq,1611,526845,327,213,114
74927,19maly46,1344,438257,326,156,170
567341,fgn2021g,1257,410054,326,165,161
242906,fsd1299,1153,376028,326,127,199
26197,gramnih,1368,446205,326,146,180
2528,guma66,1387,452210,326,186,140
107734,htgasb,1828,596218,326,245,81
123429,joannnnnna,1296,422529,326,204,122
32139,magda6776,1108,361376,326,92,234
231629,maniutek777,1247,406833,326,142,184
565111,optimister,1799,586689,326,229,97
226103,pawelst12,1346,439097,326,160,166
179882,sanchopancho,1713,558443,326,210,116
308,bequait,1316,427730,325,172,153
228174,bestlife,1582,514221,325,185,140
4456,matinow24,1407,457356,325,174,151
290174,naxx33,1213,394373,325,168,157
273562,plum10,1515,492652,325,205,120
340615,pwp4466g,1481,481366,325,142,183
596448,tom1993,1406,456951,325,184,141
23922,wentu19,1252,407132,325,175,150
375459,wpiotrekz,1199,389699,325,145,180
348604,wsmcr,1242,403964,325,149,176
133979,agatkalove,1752,567843,324,229,95
138620,agatkaloves,1603,519637,324,181,143
520853,caius,1553,503219,324,176,148
650058,ftm7940g,1443,467704,324,197,127
594280,fwt2156g,1359,440454,324,192,132
52182,grzesiekpl88,1351,437875,324,166,158
1795,matim00,1631,528717,324,149,175
7086,rabbcio1,1311,425052,324,159,165
104104,reloop000,1289,417724,324,144,180
2612,squakea,1143,370479,324,131,193
177276,tbdominik,1199,388614,324,163,161
223823,wysportowany,1365,442474,324,139,185
565386,dkp1321g,1218,393548,323,166,157
443028,dwb5708g,1402,453052,323,191,132
22368,guidam,1350,436361,323,151,172
335927,is0,1453,469436,323,172,151
17459,k42dawid,1454,469782,323,200,123
610096,kokos,1825,589794,323,240,83
140623,maciej9933,1194,385846,323,131,192
230490,maciekr1,1311,423506,323,169,154
87568,pank666,1360,439543,323,229,94
192014,stoki13,1228,396733,323,151,172
637904,vitock,1615,521933,323,181,142
142390,wcd8063g,1567,506264,323,151,172
582113,13do1zajazem,1826,587977,322,239,83
34904,94vanpersie,1196,385195,322,182,140
378933,adamskass,1244,400609,322,163,159
113563,ania1lusia,1175,378601,322,141,181
281332,bpd5270g,1299,418574,322,200,122
21075,coco,1414,455489,322,157,165
240194,djloobicz,1360,438148,322,176,146
16260,fajnycooles,1619,521331,322,172,150
511268,gosciu876,1821,586664,322,228,94
142756,idb,658,211951,322,122,200
324267,kidcat,1583,509837,322,183,139
30661,kubb07,1259,405672,322,180,142
113052,kurczok100,1283,413212,322,196,126
590539,markiz11,1178,379496,322,138,184
118916,miko1980,1356,436713,322,184,138
90454,mistszuniu,1211,390258,322,135,187
571981,nowicjusz82,1784,574734,322,193,129
425772,ponczoszka,1248,402013,322,152,170
100815,rapaddix,1599,514891,322,185,137
221096,smogorzow,1167,375871,322,146,176
159839,tbd6835g,1513,487335,322,213,109
580438,twp8874g,1217,392188,322,135,187
263830,zyganiedopupy,1454,468300,322,187,135
560182,assarhadon,1213,389626,321,134,187
21980,daw05,1261,405043,321,201,120
2740,djsolovey,1637,525600,321,178,143
29415,duszek998,1393,447404,321,223,98
24072,ejryk18,1285,412750,321,146,175
252364,gkd7203g,1531,491538,321,191,130
326534,ktmluki,1194,383502,321,162,159
9831,mattt20,1475,473637,321,193,128
1764,melumeloo,1371,440105,321,176,145
189550,mfc1445,1056,339113,321,75,246
205835,mws4177g,1431,459660,321,185,136
269773,nmw1256g,1224,393064,321,151,170
58249,only7day,1690,542605,321,200,121
30091,rajtex,1462,469484,321,253,68
149185,react,1608,516265,321,173,148
8851,s0ngohan,1653,530773,321,156,165
98281,tomikme,1210,388496,321,151,170
324086,volleyballer,1325,425552,321,151,170
184654,zielony7777,1348,432970,321,140,181
103027,batistacooll2,1436,459734,320,192,128
514439,cpf591g,1336,427583,320,187,133
94385,dusiaxoxo,1230,393677,320,157,163
79424,gabrielae,1115,356992,320,108,212
25139,kajunia201,1345,430434,320,233,87
230217,kamilof55,1302,416940,320,177,143
180085,onlineegracz,1567,501755,320,174,146
295638,ptf1612g,1332,426507,320,195,125
5150,sportowy1991,1267,405458,320,171,149
331890,tomekkk87,1318,422065,320,155,165
330120,tsf7068g,1555,497834,320,206,114
313217,twojziom,1500,480099,320,220,100
547008,ajacied,1418,452607,319,207,112
86524,chlopzwidlami,1510,481892,319,198,121
35994,comebackk,1580,504274,319,151,168
28123,curlyd,1446,461416,319,152,167
40697,gnb5765,1240,395815,319,178,141
250310,ipe,1521,485414,319,250,69
3387,misioq97,1227,391445,319,132,187
2074,solan0,1260,402111,319,140,179
199623,yeri,1415,451526,319,153,166
172938,buritto15,1224,389337,318,124,194
2366,bwelejegraczy,1656,526778,318,146,172
14068,danielek25,1351,429695,318,130,188
73241,dhs444,1533,487680,318,152,166
1800,edytam94,1135,361024,318,107,211
129656,elementoo,1363,433584,318,198,120
405263,goluchtoja,1564,497625,318,183,135
285471,hatifnat,1291,410660,318,130,188
132579,kisiel7070,1296,412362,318,165,153
130870,labalabam,1371,436174,318,158,160
311274,paprotka1001,1205,383212,318,167,151
73828,pendragan,1326,421772,318,143,175
182871,pogromcamajdy,1963,624460,318,250,68
47130,sikora1982,1155,367550,318,120,198
221711,widmowo,1622,516081,318,180,138
3054,1minucia,1680,532793,317,172,145
425907,cks9802g,1400,443882,317,188,129
665068,dbn7808g,1322,419210,317,147,170
76568,funkygroovy,972,308368,317,45,272
155661,ggd1359g,1234,391311,317,144,173
6443,keladra123,1249,396200,317,135,182
99057,lewatywax,1325,420327,317,142,175
1120,mareck25,1378,437048,317,130,187
19799,mat2002,1224,388289,317,167,150
519564,matus95,1269,402335,317,175,142
278555,mww5141g,1351,428360,317,162,155
24275,wr00bel,1453,460692,317,167,150
85564,xhomix,1374,435810,317,159,158
90229,83cichy,1278,403975,316,175,141
23514,damballah,1566,495088,316,169,147
119860,dkf6137,1111,351117,316,92,224
1211,gorogoro,1334,421687,316,176,140
509074,sgg1376g,1195,377891,316,149,167
85843,szyszka5,1312,414666,316,165,151
283483,wfn7985g,1336,422457,316,151,165
30300,120groszy,1386,436711,315,182,133
594,3pid3mia,1624,511809,315,176,139
100582,bimbala,1269,399934,315,142,173
428484,bpc9136g,1356,427309,315,156,159
588416,cbg2373,1246,392794,315,136,179
39975,cosmaty82,1429,450309,315,154,161
4763,czeal,1251,394278,315,140,175
1348,djarturo3,1349,425138,315,151,164
288017,eragon14,1320,415990,315,161,154
584298,grindii,1347,424440,315,156,159
644823,kgb6272g,1322,416552,315,164,151
21564,majinvegeta,1604,505543,315,191,124
592226,mwd1619g,1079,339958,315,90,225
161015,oficerwiking,1139,358907,315,127,188
65007,talibka,1306,411468,315,161,154
525988,tba,1694,533811,315,169,146
21524,trabka,2016,635266,315,262,53
1360,walleye123,1213,382286,315,148,167
329481,cgn5980g,1422,446700,314,179,135
46570,cristiano987,1463,459693,314,212,102
4275,cul8rornot,1353,425057,314,189,125
257608,gws8770g,1207,379276,314,137,177
90109,kebabpl93,1234,387495,314,152,162
35436,licek,1632,512484,314,170,144
145923,longer2m,1395,438196,314,186,128
196378,msmr,1527,479710,314,186,128
62885,muchowaty,1501,471546,314,271,43
114149,rakotworczy,1589,499011,314,134,180
317409,ttg7286g,1458,458106,314,167,147
571552,waraxer,1651,518479,314,220,94
553928,bartolo7676,1324,414495,313,162,151
251513,bizon1944,1205,377461,313,231,82
201600,boty,1576,493353,313,172,141
196984,chrmik,1231,385456,313,144,169
53700,demidomi,1198,375043,313,180,133
382721,furiattt,1192,373384,313,147,166
235958,himeji,1144,358323,313,103,210
20394,joaszka211,1236,387122,313,173,140
348803,ksk4565,1262,395077,313,154,159
194143,mrmoritz,1383,433076,313,188,125
162743,pesw,1208,378404,313,136,177
69438,sawerty29,1517,475060,313,179,134
131402,szikiratki,1043,326655,313,60,253
582918,technika1,1458,456515,313,161,152
211813,0li0nt0rez0da,1489,464608,312,171,141
554,13kacper13,1541,480871,312,160,152
4182,dufon91,1199,374337,312,158,154
9795,henjjo,1333,415962,312,166,146
387663,jasik26,1374,428890,312,186,126
136104,jedengest,1554,485145,312,150,162
202615,jurajhip,1257,392324,312,199,113
89939,kamiloss20,1218,380087,312,140,172
3060,legendaryy,1819,567695,312,135,177
62688,legiaw1995,1368,427024,312,172,140
101522,minikum,1574,491226,312,253,59
2040,mistrz793,1381,431092,312,171,141
53050,pemper,1264,394585,312,150,162
169605,rezjak25,1027,320505,312,67,245
80588,riveted,1607,501487,312,148,164
280642,tifunia,1583,494128,312,178,134
627182,bbs7187g,1434,446090,311,203,108
91086,christravis,1686,524428,311,196,115
529120,gfs4696g,1324,411868,311,157,154
5878,kurpzielony,1326,412544,311,165,146
145742,marcinkpo,1339,416539,311,176,135
533412,nfd8232g,1482,461009,311,206,105
256552,pck8558,1237,384933,311,175,136
635587,reu,1720,535123,311,205,106
58840,senio,1706,530587,311,182,129
25383,terrywsh,1236,384421,311,149,162
160421,tkw9456g,1235,384135,311,155,156
152447,tomaskoru,1529,475703,311,194,117
30228,0oprezeso0,1411,437662,310,129,181
136464,corina18,1232,382049,310,137,173
331525,daamiaan94,1184,367212,310,146,164
376499,knn7925g,1361,422189,310,156,154
154602,ladnapanda666,1278,396447,310,137,173
4574,mariomax23,1339,415399,310,212,98
82200,markol9,1325,410943,310,165,145
625206,mds9849g,1243,385501,310,141,169
470739,peksel,1245,386180,310,122,188
554181,pft5040g,1517,470333,310,228,82
506860,pgn7502g,1288,399442,310,159,151
980,przemekk2013,1235,383153,310,115,195
25990,sabinka448,1166,361704,310,131,179
4998,sieczus121,1365,423442,310,169,141
294196,welika,1229,381085,310,186,124
646974,wps1041g,1208,374638,310,152,158
135313,5th,620,191773,309,79,230
591821,abelard71,1261,389781,309,161,148
404380,fbf2269g,1436,443745,309,185,124
165893,mesiuv6,1369,423098,309,186,123
343131,project46,1440,444975,309,185,124
332348,tks6009g,1244,384404,309,142,167
155419,wriggle,1403,433680,309,153,156
7697,zajcuniu,1532,473598,309,171,138
149673,aimse666,1233,380064,308,148,160
115024,bugauga,1571,483881,308,196,112
61762,czare87k,1234,380346,308,115,193
212869,dawrta,1270,391343,308,180,128
172493,fajnamila,1477,455097,308,179,129
80498,glaneczka,1195,368107,308,115,193
6055,gonzopawel,1285,395952,308,155,153
505874,krissmonmon,1221,376152,308,143,165
406970,michalj1989,1298,400083,308,143,165
44558,mucha00,1258,387475,308,138,170
273848,queen143,1243,383093,308,145,163
47351,sebakuz,1336,411774,308,165,143
247149,sgm9646g,1306,402491,308,168,140
333949,takeshi91,1266,390066,308,183,125
5128,zimnaaaaa,1352,416509,308,149,159
19756,abvc,1375,422344,307,198,109
202616,anulac42,1148,352538,307,109,198
94080,asiam23041990,1191,365691,307,124,183
240613,catapilar,1594,489413,307,289,18
571764,ckg9123g,1271,390374,307,155,152
325624,jakotako85,1328,407750,307,159,148
41264,karolina3004,1271,390261,307,154,153
96787,kubalysy,1428,438498,307,167,140
52361,lepperbos,1239,380471,307,154,153
171147,natti24,1119,343626,307,98,209
256495,spg3743g,1214,372780,307,148,159
375255,viesp,1271,390204,307,164,143
162810,wszechmistrz,1380,423965,307,227,80
53925,xosa,1385,425424,307,141,166
774,333e,1874,573729,306,157,149
292165,adamkarni911,1328,406533,306,182,124
202677,akihiroiniha,1315,402627,306,207,99
106153,argument,1662,508869,306,143,163
379319,fcs5529g,1290,394842,306,189,117
642775,flakintosz,1222,373953,306,146,160
20787,mamadaniela,1551,474798,306,145,161
230474,mmarek1,1438,440038,306,205,101
266938,partyzant909,1165,356721,306,128,178
293246,pom7,1498,458390,306,196,110
425218,tof99,1232,377003,306,122,184
173445,vinnav,1220,373613,306,126,180
11693,wypadek2010,1312,401522,306,123,183
457228,charib,1212,369810,305,141,164
228552,coolers,1572,479573,305,155,150
247308,fkw654g,1307,398924,305,174,131
598124,gmx,1391,424454,305,179,126
372612,hifey,1614,492419,305,147,158
84225,kochananatuss,1222,372987,305,108,197
83563,kwasimodos,1518,463280,305,173,132
29924,man13united,1253,382236,305,149,156
423627,nikdlajaj,1609,490842,305,157,148
51392,r1wizu,1275,388904,305,131,174
10155,rafalalala,1995,608552,305,155,150
199039,revenboss,1674,510801,305,193,112
49369,roczeto,1278,390090,305,149,156
235608,skoczylas,1348,411321,305,162,143
50721,toma7366,1580,482066,305,187,118
285399,tomaszkarol,1283,391466,305,152,153
84226,totkdragoon,1334,406898,305,197,108
125672,utopia0,1355,413438,305,133,172
221113,wtf6969,1556,474804,305,174,131
162868,yberf,1234,376646,305,135,170
637427,1power1,1497,455176,304,177,127
13647,astert,1491,453532,304,265,39
5107,dozo,1918,583196,304,209,95
97116,farciara1988,1376,418367,304,167,137
426545,fsw2824g,1396,424395,304,223,81
408069,ftd5411g,1414,429891,304,220,84
147137,joerogan,1505,457570,304,155,149
476833,kgt6348g,1357,412707,304,207,97
290173,kozlarz123,1196,363754,304,146,158
1224,kstan,1292,392956,304,168,136
506740,kula9999,1184,360006,304,146,158
440938,legion91,1225,372467,304,162,142
225831,maniosexpl,1350,410680,304,150,154
449690,pkd6710g,1225,372552,304,140,164
39026,staromodny,1716,521845,304,204,100
580185,ksf2601g,1307,396118,303,203,100
308841,kwiatek0719,1236,374787,303,154,149
121352,matik1920,1278,387461,303,161,142
32022,mowmidzaba,1602,485463,303,163,140
37548,paola1913,1260,382003,303,224,79
138089,pelenswiata,1393,422102,303,164,139
11842,radzixu,1251,379303,303,153,150
445610,sopel1007,1232,373391,303,162,141
574725,stb4276g,1401,424624,303,159,144
228087,sumowania,1613,489040,303,178,125
54360,eric2,1253,378568,302,142,160
392519,frwd,1462,441611,302,165,137
125328,gkm4377,1333,402656,302,140,162
521,grubyalibi,1542,465953,302,165,137
386810,kbs3691g,1405,424469,302,224,78
592904,kpm9325,1294,390864,302,139,163
202,marcelo1111,1171,353658,302,125,177
444370,mbg1192g,1308,395264,302,163,139
588081,miisssiia,1269,383283,302,161,141
338983,mlecz2000,1429,431733,302,273,29
304818,moni401,1442,435605,302,209,93
565245,nnp8768g,1402,423592,302,190,112
498697,paninzynier,1710,516433,302,212,90
163690,prjemek,1374,415244,302,165,137
102475,r1udy,1313,396545,302,147,155
141894,skortom27,1532,462690,302,187,115
14133,slaw28,1307,394950,302,171,131
192342,szisbuda,1439,434676,302,184,118
107604,vitoscaletta,1666,503133,302,179,123
44945,wygraszemna,1204,363693,302,131,171
211297,17arkadiusz02,1388,418054,301,195,106
85302,azyl44,1624,488958,301,261,40
515803,bgb3682g,1356,408227,301,188,113
137638,ememef1976,1259,379054,301,156,145
16644,hooooopka,1391,418988,301,144,157
24754,kisiel14,1543,464727,301,156,145
37892,kowalskirulez,1244,374580,301,150,151
14481,looooser,2015,606754,301,202,99
89143,misiek699,1309,394012,301,190,111
551828,raztakraztak,1271,382654,301,137,164
394492,tbd7432g,1493,449534,301,240,61
633281,thraxx,1626,489476,301,214,87
574744,witu91,1387,417533,301,172,129
337173,altctrldelete,1405,421663,300,149,151
520895,jankowalski,1233,370108,300,164,136
247233,kisciok,1576,472927,300,215,85
41999,pscoa,1101,330487,300,103,197
273935,vanillaa,1152,345658,300,112,188
1464,windek,1318,395492,300,166,134
503932,xvvx,1554,466322,300,175,125
583698,1wacek,1476,441462,299,151,148
9172,apoz,1290,386002,299,105,194
640148,bmn1388g,1281,383110,299,166,133
216882,cfs6234g,1450,433561,299,132,167
92889,czarna66,1259,376500,299,145,154
268594,fdp5293g,1201,359395,299,136,163
550254,fgg2137g,1378,412078,299,180,119
608008,mariusz198208,1260,376916,299,161,138
31260,mateusz6060,1311,392038,299,157,142
38764,pawlo07,1368,409096,299,171,128
18224,5ka,1670,497798,298,159,139
26208,bangsbo,1353,403335,298,152,146
65254,cycek006,1227,365863,298,140,158
159340,czoosnek,1526,454850,298,158,140
37549,damianjuve,1066,317867,298,75,223
13772,didek177,1559,464584,298,123,175
494907,dwp7817g,1349,402187,298,186,112
535689,h0bby,1676,499515,298,191,107
579974,kabkab86,1498,446608,298,177,121
35517,kmm357,1359,405205,298,182,116
50040,krzych7654,1245,371048,298,149,149
355047,malinovva97,1259,375336,298,176,122
60579,mcdarf,2194,654025,298,160,138
406630,nbt9347g,1476,440098,298,208,90
59466,nupster,1123,334758,298,105,193
24561,ogorkii18,1370,408354,298,174,124
2331,plusssz,1942,578855,298,160,138
15173,teatov,1314,391830,298,143,155
188371,vecna,1202,358304,298,128,170
50233,abmeiz,1231,365799,297,158,139
259471,analwabeta,1326,393827,297,160,137
443,arokicki,1434,425933,297,194,103
411,bedezolty,1400,415998,297,183,114
609358,bmt6436g,1446,429756,297,223,74
524468,bomberr,1484,440784,297,157,140
66741,chomik1234,1139,338319,297,125,172
19259,chw414,1501,445930,297,212,85
200861,czerwonykmerr,1316,390922,297,130,167
282600,dansowal,1200,356451,297,135,162
243257,dymoin,1310,389130,297,160,137
3225,habar,1371,407475,297,148,149
202804,kalaf1,1237,367500,297,155,142
47986,kreconka,1329,394845,297,170,127
226655,lis28,1243,369355,297,145,152
649093,lysyzbrazzers,1687,501291,297,170,127
626357,meczyk,1530,454546,297,130,167
440880,mfd4610g,1300,386311,297,165,132
11093,ruiess,1961,582565,297,166,131
267903,sts2745g,1353,401901,297,172,125
89658,vectra204x4,1483,440673,297,173,124
12541,byczek96,1192,353108,296,140,156
171557,fkd5970g,1371,405996,296,166,130
1987,gryc123,1321,391104,296,133,163
1353,jakikolwiekin,1343,397784,296,166,130
119541,kici0kici,1242,367650,296,150,146
236308,lolexy66,1296,383714,296,157,139
4669,madziula1414,1467,434286,296,199,97
111913,maly710,1255,371710,296,155,141
147091,matir22,1467,434348,296,164,132
191279,movedizos2000,1186,351106,296,143,153
5732,mrcin,1388,410885,296,111,185
648199,mtk9694g,1314,389189,296,146,150
223,pavvulon,1256,371921,296,139,157
378287,robson4x4,1420,420540,296,150,146
30566,rozkminka28,1126,333541,296,95,201
101980,rudylight,1199,355132,296,126,170
157988,staruszek98,1324,392151,296,143,153
127219,touring,1431,423759,296,166,130
14347,v8v8,1371,406084,296,174,122
114,b00t,1294,381938,295,155,140
603225,bmt9810g,1141,336688,295,108,187
28738,bwebingo,2054,606156,295,184,111
892,deathinchains,1390,410074,295,190,105
635698,fgk442g,1644,485175,295,241,54
601363,kbc5267g,1165,343950,295,112,183
80989,klaudiagda,1254,370078,295,132,163
103908,ladyyy24,1229,362580,295,163,132
101628,legionista07,1313,387342,295,160,135
8850,lujaro4,1322,390159,295,196,99
56763,mizu1,1487,438716,295,126,169
162122,modebull,1221,360474,295,145,150
621403,papahet,1195,352775,295,142,153
128820,agata0018,1315,386789,294,178,116
406171,cof,1787,525543,294,178,116
448093,dff361g,1364,401027,294,201,93
60760,jacekplacek90,1271,373826,294,165,129
149851,kcbkotku,2131,626750,294,178,116
355405,kts7690g,1209,355549,294,123,171
158972,marsyl74,1394,410105,294,210,84
115858,mootchowder,1429,420310,294,141,153
253647,myprincess,1373,403865,294,149,145
475791,sgf8724g,1537,451879,294,187,107
475612,tgc226g,1301,382761,294,146,148
63234,tiz,1197,352098,294,116,178
33403,zizu1011,1385,407246,294,170,124
146956,zosia2211,1172,344572,294,116,178
668971,bandura117,1469,430587,293,252,41
25459,bogacz16,1132,331779,293,134,159
59013,ciacho20,1368,401007,293,212,81
591508,cpt2019g,1416,415079,293,147,146
374151,czarny3,1194,349887,293,110,183
25507,draxensuperr,1211,354937,293,111,182
122542,ftw751,1303,382071,293,140,153
553366,gwc613g,1373,402564,293,193,100
55672,hereditas,1270,372243,293,157,136
234586,marcino1987,1431,419375,293,228,65
3266,michalsaviola,1458,427445,293,163,130
247376,nieogar,1397,409452,293,138,155
15284,sarna1993,1437,421107,293,218,75
10293,saturn2210,1266,371108,293,157,136
83873,skor15,1531,448718,293,196,97
73675,andrzejkosmo,1333,389408,292,182,110
101706,calsiver86,1578,460809,292,169,123
114086,damianisko,1371,400477,292,124,168
845,dominko08,1333,389319,292,200,92
65496,dulopl,1623,474153,292,150,142
574108,gwm2603g,1258,367545,292,138,154
24582,jasiek8880,1156,337634,292,104,188
22493,jnoiztch,1181,344982,292,140,152
3221,jp2lubidzieci,1202,351244,292,122,170
11243,klaudiazabka1,1145,334524,292,132,160
280625,kondziu06,1421,414957,292,167,125
150265,koszernypan,1319,385223,292,125,167
49357,polkmnp,1436,419501,292,193,99
34629,qba270496,1112,324867,292,90,202
12868,smerfetka1119,1204,351826,292,123,169
400735,target79,1234,360572,292,155,137
515124,tbt4885g,1358,396662,292,171,121
194565,vego25,1627,475177,292,147,145
75302,wpadlawoko,1514,442149,292,149,143
108569,1236y,1265,368205,291,162,129
92821,abyss,1327,386224,291,131,160
14222,balisong,1606,467534,291,189,102
77778,bigtony,2148,625168,291,212,79
476776,dkn2080g,1302,378901,291,138,153
664156,fbd7331g,1626,473240,291,201,90
142453,fuh,656,191038,291,40,251
199299,gra29,1320,384315,291,142,149
576588,htsi99,1308,380836,291,164,127
565158,kcm5663g,1317,383452,291,126,165
13143,luki19323,1385,403303,291,163,128
132259,strados33,1575,458466,291,240,51
282274,szczurex,1128,328417,291,101,190
8544,xey,1386,403464,291,151,140
10250,arntor,1494,433380,290,148,142
135825,avocadoooo,1487,431427,290,142,148
74371,dafi123,1419,411725,290,178,112
21784,el3872,1495,433631,290,155,135
430548,gargan,1540,446838,290,163,127
103474,graft31,1223,354893,290,165,125
359199,k0rwa,1353,392604,290,165,125
68736,lixian,1565,453912,290,160,130
17785,lukas2412,1334,387068,290,172,118
573936,mdk8938g,1304,378313,290,158,132
659386,mmm7714g,1480,429317,290,161,129
482905,nfm3531g,1238,359070,290,132,158
354147,ngd8913g,1536,445469,290,195,95
11346,radek14,1372,397889,290,134,156
163640,robinsonkesly,1938,562183,290,203,87
2933,uhan,1920,556821,290,178,112
26747,wkm2062g,1213,351932,290,112,178
10082,wojtekk8,1298,376568,290,160,130
600218,zagramwszyscy,1584,459363,290,171,119
570065,denverek,1549,447688,289,182,107
43721,dominik2088,1398,404284,289,193,96
258183,dzysxd,1955,565071,289,204,85
393759,fsd5645g,1161,335614,289,128,161
75627,inwalidy,1883,544273,289,185,104
9751,iwona84ola,1223,353632,289,141,148
321346,kbn4996g,1334,385765,289,177,112
475381,kkn9127g,1273,367964,289,150,139
420169,krysx,1500,433567,289,123,166
66904,majkel1978,1208,349185,289,112,177
5249,masley,1921,555414,289,190,99
269659,mihau993,1234,356691,289,113,176
14814,monialak18,990,286333,289,66,223
94459,nutella199,1220,352610,289,105,184
36170,paulincia1,1222,353230,289,151,138
55954,pietrass95,1359,392788,289,188,101
116833,robson997,1293,373812,289,173,116
195247,stranaks,1569,453541,289,203,86
354852,tanksztela,1452,419717,289,175,114
242820,transporter82,1136,328552,289,120,169
321762,waldipc,1230,355519,289,140,149
221153,wartos,1697,490468,289,203,86
102053,westermanagee,1370,396091,289,136,153
30130,1stdan,1578,454697,288,258,30
22870,bialakreska,1670,481021,288,209,79
541331,booruciak,1525,439216,288,252,36
277210,dsw942g,1304,375611,288,159,129
116746,fanatyczny,1544,444945,288,147,141
23619,igor400,1394,401752,288,155,133
134749,jordan90,1283,369619,288,143,145
23776,krolpilki,1319,380006,288,127,161
102464,legionistka20,1129,325365,288,113,175
61974,machet,1290,371786,288,162,126
17453,matek132,1290,371780,288,151,137
386919,miodzkaszanko,1425,410645,288,173,115
23332,mmmurt,1368,394058,288,176,112
265146,msp4999g,1030,296871,288,56,232
225979,pmk1727g,1352,389458,288,203,85
629712,qaz0007,1185,341302,288,114,174
14950,ricardolepra,2029,584537,288,184,104
62969,turtymasik,1358,391300,288,156,132
115293,tygryskaaaaa,1195,344238,288,138,150
562863,wgg2408g,1343,387006,288,173,115
216706,alantugra,1318,378436,287,172,115
1741,bulsonn,1614,463325,287,152,135
131758,ccciastek,1568,450231,287,143,144
434553,dsf7213g,1341,385104,287,157,130
397376,hakkaii,1355,389087,287,237,50
66862,poiuytre951,1457,418342,287,129,158
475485,pst6147g,1415,406247,287,196,91
73837,sirgizbert,1389,398909,287,143,144
164248,sk0crookers,1408,404135,287,165,122
179356,skortom73,1517,435387,287,178,109
181265,strings,1708,490270,287,159,128
6921,teyadogo,1398,401410,287,211,76
646271,wrobellll,1326,380688,287,139,148
6882,xxnatalia,1427,409683,287,184,103
397223,xyzc,1221,350527,287,131,156
200835,zmuszona,1251,359085,287,165,122
128338,cng401,1288,368508,286,141,145
3903,daro06,1405,401949,286,152,134
149,domkaa,1368,391444,286,163,123
12895,elmohico,1382,395264,286,111,175
606637,evilmonkey,1236,353756,286,179,107
358331,glonojadojad,1247,356709,286,127,159
312527,kurdystan231,1420,406240,286,167,119
61376,malgosia11,1270,363249,286,124,162
50334,nikodem00,1453,415828,286,175,111
88376,nowechlopaki,1392,398291,286,152,134
62433,teydash,1214,347483,286,101,185
377558,urban1512,1247,356872,286,156,130
53046,wiesiulek11,1269,362971,286,121,165
152734,wrakatakpl,1489,426019,286,178,108
454547,wtp3388g,1355,387704,286,205,81
345276,yannyi,1071,306467,286,78,208
93174,zenko12,1315,376160,286,157,129
386799,zryjgruzz,1227,350948,286,144,142
30362,19olek72,1375,392033,285,148,137
268776,alex12333,1451,413595,285,144,141
252636,ftb9648,1202,342832,285,122,163
2158,kolarz13,1345,383464,285,161,124
616725,konrad88,1590,453348,285,155,130
13554,lecpoogry,1330,379256,285,158,127
25274,mchoncer,1320,376433,285,177,108
36652,mewtwovsmew,1706,486332,285,190,95
78140,mlody1312,1412,402576,285,168,117
291789,mwd9049g,1297,369695,285,143,142
115043,pardys,1368,389978,285,117,168
93955,piotrek1719,1227,349801,285,142,143
531162,pmb4682g,1375,392080,285,157,128
439479,ptb7917g,1325,377792,285,156,129
173416,rorymcgregor,1512,431154,285,171,114
86762,wandamm,1556,443486,285,171,114
479583,wbm6982g,1078,307255,285,76,209
65661,xyloospryay10,1467,418168,285,127,158
20674,adis75,1226,348330,284,140,144
195798,boniu3,1269,360455,284,142,142
15413,darian22,1232,350031,284,147,137
343749,fbt551g,1243,353121,284,129,155
604555,ftm6252g,1320,374919,284,139,145
9526,grinds,1280,363732,284,140,144
146828,hy65tg,1233,350393,284,126,158
217,kluskii,1500,426233,284,163,121
165901,kmb1199g,1318,374559,284,140,144
539845,mcf1644g,1372,389694,284,164,120
453352,powrotpoyears,1591,451904,284,157,127
3150,ranking1500,1383,392965,284,131,153
75883,trap3r,1621,460372,284,169,115
179513,bartekke,1301,368330,283,155,128
168519,dawajszczura,1239,350656,283,122,161
12331,filipszach,1293,366013,283,131,152
128814,fizlesure,1285,363809,283,132,151
504751,i7777,1234,349476,283,142,141
300733,kojotol95,1430,404698,283,188,95
627735,kolegium,1410,399094,283,130,153
328791,lysypazdan,1166,330081,283,139,144
405510,mackop,1296,366897,283,167,116
271276,nightbefore,1239,350783,283,105,178
597651,pnw455g,1239,350771,283,118,165
87355,ryjpsie,1288,364575,283,160,123
230409,alitatka,1327,374416,282,150,132
95811,arekk4,1223,345006,282,132,150
8815,bocian004,1304,367867,282,142,140
231892,edercarbonera,1176,331715,282,119,163
310898,folciak5,1356,382420,282,162,120
24794,grzesieks1103,1278,360629,282,167,115
205827,johnnybambo,1269,358035,282,155,127
119082,keicam47,1458,411163,282,176,106
7320,kihna112,1406,396523,282,147,135
24997,rumcajs31,1618,456279,282,196,86
3897,saragossaspain,1477,416777,282,161,121
1278,ssp4822,1239,349622,282,118,164
41019,stejtam2,1250,352745,282,130,152
384011,tkm8165,1268,357587,282,148,134
499941,tomek2324,1314,370576,282,151,131
153887,victorixx,1172,330689,282,121,161
56916,wader1x1,1452,409543,282,183,99
243212,wirujacybolek,1353,381813,282,145,137
76887,dino0123,1252,351925,281,159,122
425240,gwc9073g,1387,389888,281,146,135
27085,jaorooo,1236,347498,281,152,129
364952,l0lip0p,1688,474562,281,187,94
376948,loko61,1575,442627,281,179,102
74436,panikacha,1177,330863,281,86,195
466828,stanior91,1301,365605,281,152,129
4947,swierkocin,1429,401623,281,174,107
117844,trodzano,1388,390137,281,148,133
131349,trolling,1483,416955,281,199,82
502866,voytec3,1262,354832,281,180,101
100015,angela0latwa,1559,436758,280,215,65
186590,anit52,1278,357892,280,151,129
255407,bartocha1313,1251,350422,280,131,149
38258,karolasterka,1147,321363,280,94,186
102912,kubisztal8,1337,374603,280,150,130
630055,matiaz123,1624,454755,280,280,0
326433,ndp6316g,1077,301617,280,120,160
611992,nkn6103g,1322,370325,280,186,94
61292,ruiz,1964,549991,280,172,108
68186,silny1,1617,452863,280,214,66
318127,sst3029g,1299,363815,280,154,126
547913,wsp4759g,1542,431981,280,166,114
62285,xnawiedzonax,1204,337210,280,122,158
188173,bailando0,1318,367767,279,86,193
52371,bzyczek79,1228,342738,279,118,161
213172,czarnuchh,1377,384343,279,145,134
282083,czosneczek86,1254,350098,279,152,127
196203,daniel18,1232,343735,279,146,133
103441,danielbuk16,1177,328456,279,124,155
524682,dtf8860g,1223,341251,279,129,150
41960,emiliatka,1213,338597,279,134,145
385029,gdg3139g,1259,351493,279,141,138
46004,kamilror,1231,343584,279,147,132
50665,milxacz22,1156,322715,279,87,192
555383,mlodziak94,1221,340794,279,137,142
236815,natka888,1326,370008,279,191,88
46021,pjesjux,1345,375439,279,158,121
177858,putjnoscorbin,1598,445892,279,242,37
13363,silverkart,1286,359024,279,133,146
128868,tavano,1194,333385,279,166,113
466378,tomus19ii,1174,327639,279,129,150
92750,ununtrium,1498,418154,279,133,146
148812,wegry,1843,514208,279,189,90
303930,wildcaptalist,1436,400900,279,167,112
446949,wilgotnawkr,1403,391441,279,162,117
240887,wtopowicz,705,196713,279,0,279
155257,100x,1492,414855,278,126,152
22088,aroziom,1327,369126,278,178,100
597106,bartko1,1254,348844,278,156,122
22456,bizor17,1328,369324,278,139,139
170801,ciapek78,1297,360657,278,139,139
393,criscleodan,1579,439088,278,119,159
297300,cypek92,1154,321043,278,102,176
297299,drpterodaktyl,1245,346157,278,176,102
5554,jacek25,1447,402500,278,152,126
32967,jestemzgliwic,1654,459919,278,177,101
29869,kinga1k,1322,367712,278,202,76
17923,kluczyki,1361,378512,278,129,149
55028,krolas7,1407,391243,278,141,137
245334,krowa12,1307,363430,278,151,127
96166,magdalenka96,1128,313778,278,100,178
38161,marijuaana,1534,426605,278,148,130
434030,nck4636g,1380,383777,278,158,120
110826,patrycja9893,1271,353445,278,144,134
188656,skn5054g,1209,336296,278,117,161
51404,wiedzmin1998,1271,353393,278,157,121
370,wwnio,1517,421911,278,158,120
281202,5350,1639,454165,277,155,122
128184,akmurk18,1498,415165,277,163,114
517148,array,1340,371181,277,150,127
577200,borysand,1328,368099,277,192,85
85991,clark999,1374,380689,277,151,126
270334,cpn4971g,1104,305969,277,76,201
9887,gypsytheking,1435,397536,277,191,86
38314,joanna265,1130,313133,277,95,182
89566,k3433,1298,359733,277,177,100
469313,karim9,1294,358445,277,148,129
110030,loftyfever66,1275,353212,277,129,148
107724,marcin891010,1331,368858,277,227,50
27049,matilwg4god,1445,400379,277,157,120
3449,patrykkyu5,1387,384226,277,157,120
394329,poi43,1290,357489,277,143,134
107290,qwertypl,1280,354807,277,162,115
230469,rudaanna,1228,340303,277,106,171
483355,tomii3kw,1353,374888,277,157,120
408378,tpb6645,1137,315065,277,115,162
29600,adidas09,1170,322943,276,105,171
227952,andre77166,1335,368729,276,137,139
3571,annndi,1410,389290,276,150,126
250832,countrycider,1222,337321,276,143,133
528072,dfd917g,1700,469412,276,162,114
79286,gazowanykefir,1517,418925,276,164,112
30400,gmcrew,1583,437069,276,164,112
1788,kfglesnylud,1375,379543,276,127,149
66222,milczarim,1291,356330,276,155,121
444835,nnk6292g,1197,330564,276,104,172
328173,onawydupcona,1297,358078,276,138,138
250443,pablo0602,1348,372232,276,175,101
376441,profilnapilke,1505,415589,276,173,103
224503,ptc1564g,1451,400600,276,175,101
581176,sati6,1106,305495,276,93,183
617311,skc7522g,1375,379617,276,159,117
10176,tichobzdionow,1325,365897,276,106,170
2291,0028,1996,549133,275,168,107
56353,emidell174,1241,341445,275,119,156
263978,ffp9710g,1263,347330,275,132,143
149892,gotmar,1283,352885,275,135,140
276862,helios89,1337,367853,275,150,125
66678,kuciapka18,1390,382385,275,174,101
231718,maniekmaniu,1342,369220,275,205,70
71083,marianp,1213,333649,275,127,148
431535,notunenolife,1423,391506,275,151,124
391150,pkp9675g,1371,377284,275,165,110
73150,sebastian2000,1336,367487,275,159,116
16192,szczypiorfcb,1345,370044,275,196,79
232179,thefrog1,1352,372067,275,161,114
26312,ukuje,1836,504968,275,135,140
132460,wojwojwojwoj,1424,391648,275,137,138
339303,0034,1402,384401,274,152,122
65382,0rzech0wa,1503,411845,274,137,137
40342,adio216,1155,316651,274,109,165
13484,adrianrrr1,1531,419554,274,121,153
46097,bananowy18,1283,351605,274,143,131
238214,carnee911,1353,370994,274,158,116
489778,cft3362g,1347,369130,274,165,109
498638,chudas,1233,337899,274,144,130
359251,dfd6865g,1533,420280,274,184,90
4455,elewator,1327,363717,274,141,133
494589,ewka169,1493,409124,274,136,138
537564,fizyka,1794,491624,274,178,96
541247,fww5637g,1339,366936,274,159,115
38595,gszymon2202,1279,350657,274,145,129
59601,klaudusiaa53,1289,353364,274,170,104
96658,kraxa2,1560,427550,274,180,94
49711,magafaa,1359,372469,274,123,151
48799,majkimajki2,1888,517329,274,172,102
559,matig955,1280,350946,274,126,148
309505,maxspeed,1999,547825,274,192,82
201178,mistrz666,1343,368176,274,157,117
254180,neojuda11,1324,362974,274,130,144
251862,panszczepan,1301,356574,274,137,137
115471,paul2006,1170,320643,274,137,137
173845,rysiekll2015,1426,390905,274,158,116
267421,trol1989a,1334,365642,274,118,156
889,xxxmaniek95,1413,387332,274,170,104
28369,agaaaatka,1226,334818,273,176,97
2784,agagulonek,1288,351796,273,148,125
1237,boskiprzemo,1327,362276,273,135,138
248277,dziubkadaj,1547,422553,273,154,119
37690,gxxxx1,1281,349898,273,149,124
274720,kosmyk11,1514,413478,273,182,91
9882,kryswars,1280,349596,273,136,137
30508,mevlana,1950,532494,273,193,80
37266,mjpiwo,1343,366689,273,146,127
58173,mojcalyswiat2,1140,311307,273,88,185
1962,natalia9812,1125,307290,273,97,176
77375,patryczken16,1345,367416,273,186,87
365635,primordial7,1416,386586,273,209,64
307746,puszczaamsie,1320,360545,273,137,136
27239,sandraa1995,1299,354863,273,169,104
24307,sb10tbr,1361,371750,273,135,138
122221,wronaniekruq,1606,438700,273,97,176
27392,zakochana1998,1130,308728,273,108,165
11482,zzzuza,1525,416559,273,229,44
102677,acmarian,1441,392020,272,155,117
104014,agusiajedna,1209,328950,272,121,151
57132,bogdanxxx1,1194,324814,272,105,167
292910,czornyi,1411,384021,272,149,123
497102,daniel30wr,1290,350935,272,159,113
235707,dcg7398g,1356,368964,272,144,128
246826,fpm4198g,1347,366473,272,182,90
351048,gdziemnieztym,1388,377664,272,167,105
2184,krzysiek1986q,1390,378111,272,143,129
231705,l0ng64nj4,1667,453656,272,166,106
301428,lukasclk,1210,329265,272,114,158
290767,msb7741g,1542,419462,272,134,138
575082,pterodakryl,1878,511018,272,219,53
81183,qambol,1580,429795,272,175,97
101947,sandomierz888,1306,355446,272,152,120
577224,sm0keweed,1665,453067,272,134,138
13765,szeryfjunior,1123,305703,272,87,185
93856,tlll,1660,451697,272,171,101
553927,tomaszg82,1724,469087,272,178,94
7031,ucho16,1325,360576,272,131,141
196417,zaszybko,1555,422970,272,170,102
295939,184,1435,389153,271,137,134
136990,aidualkkk,1330,360613,271,148,123
4198,asia2821,1200,325238,271,133,138
372236,cns3800g,1261,341773,271,156,115
183045,fan9999,986,267408,271,41,230
12966,gbk7574,1280,347075,271,183,88
254657,gtd2052g,1306,354168,271,120,151
284596,istilllearn,1574,426560,271,161,110
449992,jaknaironie,1478,400562,271,202,69
6279,kinga188,1388,376218,271,142,129
294831,ktn4300g,1317,357139,271,139,132
68552,kustosik999,1086,294452,271,88,183
960,magdalenka82,1276,345987,271,125,146
40066,maja279,1294,350774,271,195,76
538734,niedostepnycb,1529,414406,271,180,91
31110,przemekbolek1,1285,348320,271,140,131
536046,ptp9016g,1187,321692,271,116,155
11527,pyszczek004,1147,311084,271,100,171
481562,snw190g,1288,349318,271,118,153
23,sonic20,1328,360151,271,156,115
58723,systemxp,1330,360495,271,106,165
273804,zanonim2,1288,349238,271,111,160
117607,bbbbbbbartek,1316,355585,270,177,93
541234,bergson,1336,360824,270,156,114
142410,choroba,1273,343712,270,99,171
116364,cichy66,1334,360202,270,118,152
30287,eb3,1374,371178,270,164,106
6719,gugu03,1145,309242,270,136,134
91779,jabadadud,1488,401786,270,133,137
462273,mbd2163g,1005,271501,270,55,215
96165,piteer94,1224,330706,270,171,99
623808,polldek,1695,457872,270,148,122
114219,rizo,1722,465131,270,148,122
95137,sajmon91,1315,355107,270,170,100
87158,skor66,1522,410966,270,166,104
475544,wbm1075g,1318,355919,270,139,131
1155,wybud,1345,363186,270,163,107
146285,zazdrosnikpl,1578,426245,270,134,136
513621,zbieracztp,1208,326339,270,109,161
117985,0carpow,1059,284938,269,99,170
44,1213k,1371,368910,269,132,137
99352,1datus,1179,317352,269,132,137
397884,analiza3,1705,458830,269,155,114
31057,bako3,1367,367837,269,141,128
141306,cmt8219g,1393,374831,269,163,106
380037,cpb5052g,1298,349276,269,146,123
619460,creative000,1202,323396,269,99,170
555026,csn946g,1244,334783,269,133,136
98047,elcoster,1521,409176,269,152,117
421447,fl4wless,1569,422138,269,171,98
144482,grunda,1069,287593,269,82,187
42995,jandziak,1265,340472,269,128,141
94414,kochamewsika,1611,433618,269,142,127
128869,lovciumaduzeg,1118,300843,269,104,165
172314,madziex7,1274,342832,269,185,84
246563,medeicuss,1226,329847,269,107,162
295899,mfk5157g,1228,330437,269,128,141
120635,milaussj,1412,379863,269,144,125
425045,nicky100,1230,330968,269,132,137
48427,other019,1212,326265,269,147,122
561099,ppp2015ppp,1197,322201,269,98,171
98025,rtzw,1479,397876,269,243,26
489139,skat2,1373,369385,269,136,133
405247,skierbiszort,1304,350816,269,141,128
617001,tyczi,1273,342589,269,163,106
242905,wfk6542,1228,330420,269,160,109
477391,wmn6540g,1380,371356,269,175,94
145525,xaoco,1508,405808,269,181,88
1909,zbyszko123345,1278,343853,269,162,107
111956,baginaaa,1262,338274,268,142,126
198262,bfw4194g,1263,338607,268,122,146
378,czuchwathc19,1364,365666,268,119,149
251318,dwawina,1388,372072,268,131,137
67062,egzelkasta,1251,335502,268,172,96
2861,elviiss,1442,386497,268,162,106
21902,gmlok,1633,437895,268,128,140
14549,gospo9,1389,372259,268,182,86
41440,grzegorz009,1187,318167,268,93,175
155319,husar901,1324,355097,268,185,83
236221,kamwes,1477,396090,268,226,42
348869,knw1924g,1226,328809,268,124,144
8310,kuna9,1214,325422,268,145,123
479936,lechiagda45,1259,337619,268,128,140
110726,lisowczyk3210,1356,363555,268,136,132
586060,lubietorobic,1513,405655,268,152,116
548365,nbw3572g,1320,353977,268,168,100
274014,patkuz93,1244,333405,268,138,130
645790,pmd5494g,1147,307474,268,105,163
82139,r6raven,1603,429697,268,134,134
192734,richhardcore,1364,365692,268,177,91
278742,sandaczangler,1589,425966,268,155,113
78426,skorup6673,1559,417843,268,166,102
270533,wsd5224g,1299,348245,268,150,118
155378,8cud,1232,329185,267,135,132
5562,aniusia1913,1269,338999,267,158,109
60369,czykens,1493,398721,267,148,119
234824,fmm3832g,1186,316723,267,113,154
27908,gege84,1222,326315,267,112,155
16619,jendrek54,1378,368148,267,160,107
158345,kamoenterpr,1222,326396,267,119,148
7023,maciej9,1282,342508,267,183,84
42674,marius0509,1185,316532,267,148,119
360238,pysio92,1187,317053,267,128,139
628197,sbp5383g,1412,377070,267,190,77
411406,spn7856g,1392,371672,267,156,111
655,daniel358,1384,368393,266,167,99
2344,darksman,1306,347563,266,132,134
651151,gyf,1233,328204,266,124,142
585731,kfd2893g,1426,379552,266,131,135
340353,kochamdariekc,1100,292600,266,100,166
84589,kochampeace,1051,279728,266,60,206
455061,kucykjanek,1269,337606,266,192,74
18629,madzialena33,1324,352215,266,169,97
281882,mcmxciii,1540,409777,266,171,95
343631,mr0insomnia,1433,381232,266,156,110
487669,piecki,1272,338569,266,164,102
384050,pmm5717,1414,376285,266,142,124
68291,poliglota19,1343,357486,266,124,142
195701,wsb2088,1220,324618,266,128,138
143226,arcyniebieski,1899,503301,265,158,107
92501,cukiereczek08,1530,405484,265,153,112
222990,dbg8549g,1402,371578,265,154,111
6520,dyniu8787,1459,386635,265,135,130
653845,gbm3836g,1322,350478,265,127,138
222504,grzebcio,1357,359834,265,186,79
163,kakunia91,1349,357608,265,152,113
409512,kondek5000,1451,384756,265,170,95
54576,krojonychlep,1312,347856,265,146,119
207432,mapimapimapi,1504,398609,265,156,109
138040,missofthelove,1560,413464,265,217,48
544440,mkb7213g,1441,382024,265,148,117
72323,oster89,1371,363336,265,140,125
567174,przemo25l,1327,351690,265,145,120
181985,pst9246g,1583,419619,265,203,62
1983,rydzykzewsi2,1503,398336,265,173,92
235840,tfm8861g,1172,310606,265,108,157
396197,tks5655g,1210,320767,265,127,138
43967,trawka7,1485,393636,265,126,139
72890,ubysz15,1206,319755,265,107,158
268458,wsk1,976,258741,265,48,217
7212,12lv,1372,362366,264,159,105
137021,aranelia,1177,310990,264,116,148
298650,barcaf,1384,365407,264,139,125
122365,butterflyeffe,1219,322065,264,129,135
189140,cosmo215,1234,325886,264,126,138
3340,dembi,1376,363284,264,136,128
475418,dtm2372g,1412,372984,264,197,67
50813,gohoosgoha,1263,333512,264,129,135
118830,gutierez,2144,566209,264,149,115
70073,luki1234,1264,333791,264,111,153
63610,matmor2821,1430,377623,264,170,94
404189,mpb5690g,1644,434136,264,162,102
91230,opel1990,1221,322397,264,113,151
213473,pilotteatru,1373,362606,264,140,124
566233,ptc6561g,1280,337988,264,137,127
352406,sister4you,1503,396966,264,168,96
180713,slawek0306,1314,346904,264,152,112
136362,zdenol83,1372,362348,264,157,107
607406,442,1475,388161,263,180,83
412976,alvin8,1421,373916,263,121,142
428522,andziawera,1389,365400,263,153,110
173192,bcc653g,1219,320709,263,148,115
653521,bct8884g,1256,330460,263,126,137
433860,cpc8532g,1317,346387,263,162,101
23632,deelay,1453,382337,263,173,90
5757,dirkc,1546,406830,263,163,100
548722,fgb5159g,1331,350168,263,138,125
450601,ftm2022g,983,258722,263,41,222
26792,guma0,1572,413679,263,133,130
48859,hdd,1580,415770,263,167,96
240589,igla393,1295,340829,263,158,105
30915,jacie88,1336,351529,263,161,102
439388,kamcio233,1144,300926,263,89,174
269658,klara123456789,1324,348227,263,169,94
1774,luzaczek16,1441,379232,263,131,132
8043,mokraaga,1365,359027,263,142,121
99612,nacpanaa,1277,336076,263,132,131
333109,naiskobieta,1216,319819,263,134,129
496722,nps6375g,1660,436593,263,148,115
548369,nwk6937g,1222,321388,263,119,144
458119,pojehany,1641,431711,263,157,106
198741,pokerzystaa,1357,357096,263,133,130
94321,przemoppp,1376,362007,263,137,126
382512,ros,1354,356284,263,135,128
533413,sdg8367g,1454,382499,263,147,116
226451,sebek97,1301,342244,263,158,105
475645,skw409g,1287,338579,263,137,126
406572,tbbako,1295,340815,263,158,105
158952,tessi335,1305,343368,263,152,111
57279,umyjsenogi,1630,428702,263,142,121
583228,adamadam,1280,335520,262,156,106
565172,artue234,1562,409296,262,215,47
615481,bgentleman,1369,358920,262,132,130
234258,ccp8798g,1117,292752,262,80,182
296167,cr88,1291,338418,262,122,140
412520,filipstg,1148,300934,262,105,157
476391,gkw1058g,1464,383793,262,168,94
159,gromhonorowy,1839,481864,262,168,94
46334,komaro19,1308,342764,262,139,123
321746,mamwasw,1504,394204,262,153,109
308719,manius01,1265,331516,262,149,113
60556,menelele,1454,381120,262,166,96
187653,mili0npartii,1552,406674,262,133,129
222345,notopijemy,1554,407345,262,155,107
366313,pff9494,1391,364555,262,177,85
3641,pluszapisy,1699,445191,262,151,111
294279,samsam2000,1220,319650,262,141,121
366382,spawuss,1315,344661,262,78,184
606252,ssw7783g,1312,343977,262,137,125
443793,szyni,1204,315537,262,126,136
380906,tomaszlatos,1545,404978,262,172,90
3552,zooom,1524,399441,262,132,130
639866,bsd8034g,1225,319783,261,135,126
409412,cfd1514,1199,313106,261,150,111
433694,cherrys98,1159,302735,261,99,162
38342,cypisssss2,1277,333410,261,153,108
532796,dmb3729g,1516,395847,261,163,98
3041,fikimikiitrik,1427,372612,261,122,139
630489,fnp6890g,1225,319845,261,98,163
179695,hermaan82,1416,369593,261,168,93
23503,karola2512,1270,331657,261,138,123
605034,kfg7147g,1806,471581,261,165,96
331307,kieraspl,1246,325377,261,157,104
556208,kola102,1173,306174,261,105,156
661940,ktg8443g,1387,362215,261,170,91
411216,kws5942g,1248,325984,261,138,123
64474,lukasz1998,1259,328742,261,151,110
523869,mnp6383g,1292,337380,261,149,112
179686,monis86kaa,1193,311421,261,116,145
196918,nowyseweryn,1344,350889,261,120,141
487995,panszkraut,1073,280145,261,72,189
63287,pasiw11,1601,418039,261,248,13
30122,pciapl1,1217,317890,261,111,150
78022,pinkabeja,1236,322749,261,142,119
164583,ricco81,1609,419982,261,208,53
314925,shaft,1396,364567,261,146,115
204406,siemacotamxdd,1249,325993,261,147,114
283932,weraaa971,1178,307561,261,129,132
83249,alrunak,1188,308929,260,125,135
1031,andreasek44,1472,382810,260,126,134
122377,cupkinson,1263,328470,260,139,121
2307,dziadek1109,1363,354543,260,125,135
531185,efe0509,1206,313575,260,106,154
36805,elfundator,1379,358795,260,150,110
121172,elitazabojcow,1316,342260,260,133,127
36169,jarobien,1205,313307,260,129,131
65769,joter,1231,320244,260,143,117
30563,kendi,1290,335494,260,133,127
219536,knd7073g,1452,377577,260,148,112
457343,ppw3193g,1293,336214,260,110,150
175310,robert42,1242,323045,260,125,135
1982,rysioshow,1522,395814,260,126,134
83606,shaakae,1082,281358,260,74,186
206608,sharn,1234,321074,260,127,133
123742,te3jtam,1241,322740,260,119,141
476629,wfc9152g,1206,313758,260,146,114
147703,wybornystrzal,1582,411520,260,147,113
82628,adzianex426,1291,334479,259,123,136
310783,aledan1975,1149,297792,259,97,162
302350,almightyman,1643,425649,259,156,103
173191,btd6412g,1181,306120,259,113,146
51452,darioo21,1599,414305,259,189,70
316373,dnm9061g,1271,329324,259,144,115
523102,efektownosc,1559,403920,259,150,109
278457,juszka15,1205,312338,259,110,149
1874,karolajnaa24,1303,337486,259,140,119
560683,klauninieuk,1477,382736,259,155,104
469072,kotshrodinger,1262,326941,259,129,130
607184,kubaa22,1267,328165,259,126,133
141679,matekkk,1303,337480,259,133,126
330300,msm4463g,1170,303048,259,110,149
58146,yokosone,1273,329964,259,129,130
527735,1946zawisza,1306,336975,258,125,133
16980,batler0,1272,328252,258,124,134
465265,bgw7883g,1176,303451,258,105,153
568114,bkg7652g,1351,348611,258,147,111
1010,bostonq,1299,335262,258,145,113
591079,camilooo,1242,320466,258,116,142
2569,daaaaria,1561,402741,258,232,26
665,debruk82,1401,361597,258,173,85
539986,dwf2639g,1191,307422,258,101,157
409263,fds8504g,1406,362765,258,138,120
587050,fnt4362g,1384,357236,258,126,132
141783,kaho35,1270,327699,258,141,117
217162,kamilos1307,1386,357730,258,149,109
84896,karolona259,1150,296788,258,87,171
365898,knd1493g,1250,322643,258,132,126
4233,l96,1347,347654,258,143,115
55764,lukaszkamil1,1373,354444,258,125,133
28618,mysiorro,1318,340170,258,138,120
47092,ojboliboli,1689,435855,258,149,109
220524,pbs4406g,1348,347934,258,166,92
52696,potnecijape,1329,343134,258,139,119
135992,sandrucha22,1262,325649,258,162,96
382,tatapoli,1401,361666,258,133,125
402184,ttn7409g,1417,365590,258,155,103
9367,vvidel,1653,426686,258,145,113
459183,yakuzaa,1235,318842,258,115,143
178321,193hp,1427,366950,257,131,126
2400,b0k,2109,542014,257,157,100
209707,bogdanittu,935,240317,257,37,220
509491,debruyne,1515,389606,257,152,105
396624,dziewczyna098,1248,320751,257,153,104
339182,fangitarkii,1100,282862,257,120,137
13808,foczka10,1446,371857,257,128,129
157974,georgel2384,1245,320163,257,138,119
1802,gromszczypek,1760,452364,257,140,117
177015,justadrem7,1322,339939,257,123,134
463566,madzia4112,1388,356939,257,148,109
427251,marcinkamil,1415,363892,257,161,96
132072,mcdg,1354,348168,257,127,130
80873,misiu6996,1151,295929,257,112,145
18731,nabijamslabo,1666,428290,257,158,99
612675,rzabkamonika,1508,387599,257,153,104
145815,zamafiba,1463,376152,257,143,114
337285,ad4m3k,1284,328937,256,161,95
73319,adrian93f,1381,353599,256,169,87
112907,bielat1988,1177,301542,256,88,168
516013,ckt2973g,1265,324000,256,132,124
633336,czytajjprofil,1350,345713,256,143,113
343106,dnc1234,1190,304856,256,110,146
76207,drabster,1329,340267,256,125,131
611604,grubymistrz,1507,385986,256,152,104
26943,hd3bdgj,1210,310011,256,111,145
298669,ionescuan,1475,377793,256,189,67
292858,iwilina,1283,328483,256,120,136
34992,krystian1235,1134,290364,256,118,138
578491,larwa111,1300,332920,256,161,95
257101,littledeath,1599,409520,256,160,96
388559,maciej99r,1123,287646,256,96,160
33958,maciek9877,1214,310859,256,113,143
2470,mati111p,1200,307354,256,106,150
185499,mlesik,1405,359831,256,156,100
54989,murineq,1212,310315,256,120,136
11267,pszecineg,1167,298853,256,85,171
395497,tmp6828,1203,308065,256,129,127
539640,wdw1243g,1510,386566,256,146,110
149500,bialy1993zg,1177,300200,255,105,150
6885,borysss9292,1395,355970,255,189,66
393846,chaujot,1411,359850,255,152,103
96143,dresiasz,1446,368883,255,135,120
347534,dvois,1265,322727,255,175,80
495256,echhhhh,1234,314911,255,114,141
244266,gft7689,1253,319700,255,134,121
44266,glegeza,1295,330292,255,144,111
372272,hoov021,1217,310398,255,121,134
86623,kaczmarox,1113,283959,255,80,175
155571,kojot213,1191,303789,255,111,144
151569,kokoma,1604,409189,255,129,126
583524,krzysiek21konin,1279,326315,255,144,111
13776,leshek90,1644,419302,255,137,118
135326,mgk5937,1288,328501,255,125,130
26188,miki7002,1221,311451,255,142,113
364122,mtp4591g,1331,339536,255,152,103
128419,picobela,1589,405442,255,130,125
569954,pnk9962g,1231,313983,255,129,126
277524,stobart,1298,331114,255,148,107
45971,szukamprracy,1403,357967,255,134,121
51991,tysiacgame,1401,357453,255,106,149
579161,uroszapati,1466,373877,255,134,121
127244,yongan,1531,390590,255,250,5
144046,05litra,1420,360894,254,140,114
277268,ceqek05,1298,329787,254,135,119
122689,dupcioch,1555,395031,254,160,94
259896,f01,1645,417946,254,131,123
334572,fwg9287g,1288,327388,254,182,72
77163,historyjek,1313,333562,254,122,132
230166,kiteeek,1362,346169,254,143,111
33954,kot669,1237,314330,254,128,126
88920,maciejschmid,1299,330101,254,161,93
401423,niekcemmuszem,1415,359559,254,150,104
648,pablog94,1412,358828,254,97,157
60738,pietrucha1205,1193,303263,254,102,152
439903,piterparker,1315,334083,254,144,110
337432,poolgoolpool,1429,362973,254,137,117
224644,prim0sz,1637,415982,254,132,122
65033,ramisiu,1243,315737,254,112,142
219553,refko,1267,321956,254,144,110
97916,sony1050,1136,288732,254,99,155
405649,tcs7072g,1381,350835,254,157,97
480017,wierzyszwboga,1608,408671,254,124,130
532552,wks802g,1255,318953,254,134,120
229136,alicja0414,1227,310622,253,108,145
147887,eldasensei90,1246,315435,253,140,113
217115,fazka,1327,335808,253,147,106
1147,financial,1587,401561,253,135,118
165060,frost1991,1394,352712,253,103,150
237341,hugobosss,1278,323583,253,139,114
121922,jacksparrow07,1407,356016,253,158,95
588383,jan1928,1281,324267,253,165,88
528486,katri92,1164,294566,253,102,151
171599,killerhor,1258,318477,253,126,127
124391,mokramysia,1367,345996,253,159,94
239333,mrlukaszon,1465,370714,253,214,39
256474,npp2906g,1295,327809,253,135,118
345447,ppiotlus,1259,318608,253,152,101
6449,ptt18,1327,335922,253,155,98
101,rafalek1822,1297,328142,253,109,144
198565,sania1998,1138,288050,253,112,141
178,siakry93,1428,361407,253,124,129
483736,sklepzwinemm,1212,306771,253,136,117
1056,stgkwiat,1461,369848,253,111,142
230238,vbieniuv,1304,330094,253,156,97
632207,wwp2964g,1393,352653,253,152,101
60997,xlooney,1326,335598,253,121,132
178688,zaawalisty,1424,360348,253,129,124
4415,zurbull,1351,341928,253,131,122
544831,281,1399,352567,252,114,138
244723,aleksandrka,1337,337015,252,122,130
266525,ciszaanka,1343,338475,252,123,129
527785,ctn5873g,1285,323869,252,144,108
128967,henderson12,1297,326914,252,140,112
142838,jurandovsky,1290,325264,252,121,131
8685,kammelek,1399,352781,252,96,156
120312,knisper,1226,309033,252,134,118
25481,mark325,1398,352435,252,147,105
475362,mmc5931g,1415,356808,252,160,92
143635,ncis100crazy,1496,377228,252,135,117
177144,ojetam,1534,386572,252,119,133
2455,paulagggg,1406,354530,252,145,107
564966,pfp4366g,1516,382158,252,157,95
341945,pksik100,1486,374666,252,137,115
195223,saab9322,1262,318096,252,145,107
24054,stasiu0305,1352,340788,252,174,78
410861,talibanek,1468,369983,252,160,92
616749,tms3191g,1347,339635,252,156,96
131286,tomaskor27,1515,381788,252,151,101
103316,tomsam1980,1325,333959,252,139,113
451873,ucz,1501,378275,252,162,90
222257,vardy,1998,503665,252,189,63
244989,vokotibi,1321,333005,252,135,117
35914,warriorgg,1457,367214,252,112,140
77297,24lemon,1201,301676,251,86,165
537489,alepoco8,1356,340399,251,133,118
156929,aleskwar,1600,401693,251,130,121
33584,bnb480,1259,316067,251,115,136
87340,cmcglue,1345,337838,251,148,103
182788,janekfan,1119,280983,251,129,122
447089,jestelepszy98,1857,466149,251,160,91
459343,karnet,1370,344035,251,131,120
4393,makosssssssss,1342,336885,251,139,112
525150,mathman,1367,343331,251,170,81
67623,oski25,1228,308318,251,129,122
33488,pinki203,1277,320700,251,113,138
191751,sebsonwpk,1354,339964,251,144,107
116142,varexo,1985,498423,251,163,88
495749,xxbenxx,1281,321532,251,151,100
13802,6532,1244,311231,250,92,158
174390,69kiciaaaaa69,1268,317200,250,148,102
33107,aaisha10,1221,305476,250,106,144
54741,andrzej2170,1305,326409,250,152,98
408906,blondynka16,1373,343355,250,156,94
598637,ctm1330g,1296,324155,250,159,91
39872,dmtn,1632,408018,250,153,97
657301,dsb4794g,1336,334073,250,149,101
56259,dzbanekmc,1169,292316,250,117,133
415426,eld13,1269,317477,250,122,128
30427,fawola,1431,357995,250,103,147
253015,fionka123,1268,317142,250,141,109
664007,jaktoktoo,1299,324946,250,140,110
101978,jckcmt,1299,324775,250,156,94
194677,kon2604,1382,345687,250,164,86
42594,liverpoolczyk,1311,327850,250,157,93
253879,murinmurin,1113,278264,250,86,164
67250,myslezetak,1655,413942,250,151,99
372542,perkusista,1088,272080,250,75,175
154659,posejdin,1289,322339,250,130,120
232949,prytaa,1690,422739,250,162,88
30741,starygraczyk,1999,499758,250,132,118
182725,visq7,1254,313652,250,144,106
4982,wmppykacz,1366,341674,250,142,108
592461,wpn9835g,1423,355841,250,144,106
118842,1598lori,1366,340193,249,125,124
86579,21mateusz,1323,329635,249,162,87
72782,ania07,1219,303676,249,125,124
225289,dejwik1989,1392,346726,249,149,100
199638,disste,1399,348390,249,200,49
611682,dms4933g,1378,343305,249,149,100
311277,ekscytacja,1798,447929,249,159,90
2883,eldonawolnoo,1433,356863,249,137,112
144337,gwiazdeczka1559,1255,312632,249,112,137
134986,jakubeek78,1094,272624,249,69,180
315002,jednaszansa,1374,342184,249,126,123
338313,lbg,1468,365672,249,98,151
44459,nielubieolimp,1295,322697,249,149,100
65366,nuttt,1271,316663,249,126,123
212969,paultom,1276,317922,249,152,97
575583,pfn116g,1313,327052,249,136,113
616227,radek3007,1308,325874,249,138,111
380256,ronin111,1279,318607,249,123,126
136260,cirno,1455,360866,248,107,141
502549,dami725,1133,281108,248,77,171
139673,fwp3714g,1594,395364,248,188,60
119216,malenika1998,1301,322864,248,125,123
89231,malwina3,1370,339835,248,147,101
528788,mfd7518g,1225,304029,248,129,119
39326,misiemisi,1200,297764,248,105,143
6861,pipir9,1495,370958,248,132,116
71463,plymouthclass,1564,388031,248,135,113
333556,pom5,1569,389283,248,169,79
133143,rafa321,1513,375383,248,123,125
84770,tfn2643,1265,313750,248,127,121
1254,arthur30,1325,327391,247,156,91
461722,cbw9428g,1518,375002,247,136,111
458948,dkf7346g,1557,384781,247,175,72
89821,fafik133,1218,301083,247,122,125
583687,fbf924,1128,278753,247,76,171
302337,hrabia00,1423,351705,247,193,54
66758,klopocik83,1266,312762,247,133,114
167541,lisowczyk1234,1312,324092,247,131,116
31976,malcu,1673,413406,247,114,133
158861,marlboroo,1306,322714,247,144,103
91050,ppptttwww,1322,326747,247,148,99
398527,sfm3443g,1394,344434,247,148,99
347535,skb1025g,1127,278537,247,74,173
198887,skiper17,1309,323453,247,152,95
289131,stw8256g,1284,317253,247,115,132
523,su37,1399,345586,247,153,94
377409,tmpao,1167,288395,247,117,130
124009,y4kuza,1756,433834,247,152,95
297,zagubiony1992,1653,408395,247,161,86
364405,cacek13,1256,309016,246,135,111
105151,citi,1149,282771,246,84,162
328923,dfg1232,1090,268372,246,71,175
2467,grace87,1373,337930,246,138,108
73045,hejzolek,1173,288784,246,94,152
229190,idealista26,1161,285694,246,93,153
299057,jaksiewtogra0,1520,373958,246,127,119
8340,jozef0220,1336,328704,246,171,75
371949,kojot2888,1151,283300,246,109,137
120778,marycha1745,1048,257832,246,63,183
480481,mce3k,1335,328487,246,157,89
381562,naranka11,1223,300951,246,115,131
645380,odczsudoczsu,1260,310146,246,107,139
276042,pwp5711g,1287,316640,246,134,112
289511,tfg3532g,1357,333911,246,145,101
101353,trg3216,1310,322406,246,119,127
55829,welovejb,1191,293205,246,165,81
6172,adamus90,1397,342316,245,115,130
107055,britn3yspears,1234,302346,245,104,141
436242,dabdab,1443,353728,245,114,131
136896,dzbanek,1726,423051,245,155,90
54187,estevez8,1312,321680,245,134,111
397986,fdg5233,1254,307253,245,134,111
110708,lechzdechl,1387,339897,245,119,126
1105,mentosowy,1377,337516,245,186,59
57416,myszka7919,1445,354254,245,162,83
488205,ndp793g,1115,273386,245,70,175
475738,nnw7971g,1290,316131,245,123,122
150456,theala,2013,493289,245,152,93
161933,tomaszskor,1530,375072,245,156,89
90957,x30men,1217,298176,245,105,140
182921,zbigniew897,1209,296432,245,117,128
467703,zdzichupyra,1413,346243,245,153,92
79536,zelek94,1779,435903,245,148,97
20956,5nik,2019,492797,244,127,117
104846,7955,1527,372641,244,145,99
303221,aniusia23,1109,270797,244,70,174
140887,borka2000,1254,306069,244,158,86
346968,ech0,1318,321727,244,173,71
117284,elninio9,1295,316044,244,92,152
98215,kulawysuchar,1663,405855,244,163,81
228902,marlenka19,1305,318451,244,129,115
210815,meeedzi,1061,258990,244,71,173
8962,miro1bbs,1338,326674,244,152,92
318817,mumumumu,1530,373457,244,127,117
34428,nanpro2,1151,281086,244,90,154
27950,piwnooki10,1500,366062,244,104,140
324291,saper007,1274,310894,244,126,118
231380,sbs5843,1198,292366,244,105,139
9437,slacker,1598,389924,244,114,130
286621,slodkii,1552,378898,244,95,149
88591,starakapa,1137,277508,244,88,156
636779,tatryski,1267,309332,244,95,149
69913,treningowynik,1617,394566,244,144,100
158479,wojak1321,1221,298141,244,126,118
585102,wysysacz,1521,371169,244,154,90
342070,ziomzbahamy,1334,325703,244,128,116
219189,agatykuro,1333,323983,243,142,101
366693,bmg793g,1456,354022,243,135,108
335625,brziot,1475,358609,243,136,107
561608,cdn6870g,1117,271476,243,80,163
80438,czopusiowa,1186,288291,243,101,142
129525,drapak,1239,301205,243,120,123
41917,emendi,1313,319217,243,156,87
223879,gadugadulec,1399,340192,243,133,110
14835,gancar,1472,357707,243,116,127
514545,gkm6883g,1351,328524,243,140,103
13627,hermes991,1317,320075,243,136,107
126841,karolanad,1168,283839,243,94,149
9532,lyrab123,1440,350121,243,150,93
8877,madziulkaxd98,1051,255582,243,51,192
553045,matematyka,1846,448771,243,156,87
632030,mcf4944g,1470,357307,243,157,86
622895,mcp5368g,1106,268884,243,72,171
220684,mlody1997r,1217,295858,243,120,123
12074,reniakazi,1316,319806,243,117,126
134654,skortoma27,1528,371475,243,152,91
143229,surykatka116,1393,338534,243,186,57
494870,adolf80,1375,332754,242,129,113
40690,aga22229,1198,290000,242,120,122
438096,aneczka6991,1307,316307,242,187,55
469643,arkadiusz3219,1272,307949,242,145,97
444251,darozwo15,1258,304567,242,131,111
99287,dongolo,1399,338562,242,150,92
625617,funik79,1263,305675,242,107,135
180619,gwn6160g,1561,377971,242,144,98
533403,jakosc,1903,460710,242,175,67
239354,jestemtunew,1403,339534,242,121,121
512,kasia33,1330,321944,242,141,101
47449,kiepowany,1329,321710,242,156,86
84967,klaraaaaa,1075,260251,242,75,167
221781,kmp7059g,1269,307278,242,114,128
270263,knd9524g,1268,306885,242,102,140
72544,l0stlegend,1874,453675,242,141,101
5188,lesnygrzybek,2033,492082,242,133,109
84673,likeball,1491,360873,242,123,119
266001,marijuanaaa,1847,447042,242,163,79
134691,misspoooola,1270,307467,242,121,121
498382,mtd7014g,1443,349325,242,141,101
2381,niebieskie03,1600,387358,242,136,106
18637,niemcy33,1466,354857,242,191,51
485656,pcw5573g,1205,291706,242,112,130
21879,pilka4321,1806,437212,242,145,97
636091,psw4825g,1263,305686,242,124,118
97426,strixaluco,1395,337729,242,118,124
397542,szold,1246,301731,242,124,118
194058,tomoj2pom,1658,401258,242,151,91
6683,trebuh111,1263,305821,242,141,101
22015,wikary9,1278,309305,242,103,139
1622,yulo,1300,314726,242,118,124
299310,afafaf,1347,324766,241,122,119
174717,andy1512,1223,294793,241,119,122
30145,bartbir,1344,324137,241,118,123
450716,bartekwe,1249,301184,241,123,118
160399,blacky111,1115,268732,241,78,163
68000,brightw,1208,291272,241,88,153
14685,champion27,1408,339501,241,120,121
66975,ciszak20,1336,322128,241,118,123
85429,colku,1160,279728,241,94,147
445950,d4m0w,1122,270426,241,80,161
12248,deltarobert,1600,385608,241,141,100
140454,edziu421,1199,289034,241,126,115
519995,empary,1388,334599,241,120,121
203320,eugrzebiusz,1248,300854,241,135,106
428847,gwc7248g,1237,298269,241,105,136
20978,gwiazdawoku,1396,336665,241,117,124
68723,hodaka,1523,367157,241,124,117
131876,johnypacquaio,1385,333883,241,81,160
1611,k3hl,1649,397516,241,111,130
81121,kn328,1362,328247,241,124,117
41361,makabe,1316,317167,241,134,107
88530,makas91,1136,273961,241,85,156
76703,maucin96,1439,346813,241,119,122
176943,mkp4599g,1251,301567,241,107,134
520613,nightnemo,1272,306557,241,134,107
233134,quru,1324,319307,241,105,136
75970,robert416,1403,338145,241,121,120
130833,romo25,1230,296525,241,125,116
257,skazan,1293,311778,241,137,104
281751,tojestnieto,1905,459313,241,180,61
513620,vekson,1286,310131,241,151,90
225256,wladwlad1,1391,335232,241,187,54
48,zefirek1997,1429,344476,241,134,107
134,aczu,1306,313480,240,157,83
118818,antronic,1282,307730,240,113,127
50852,bartekbrzeg,1238,297146,240,130,110
132356,chelmonski,1207,289914,240,135,105
607986,dzin,1491,358007,240,131,109
82048,judiis,1367,328203,240,158,82
188384,kamehame,1394,334636,240,108,132
634126,marcelina102,1152,276508,240,83,157
56974,matimen13,1387,333030,240,173,67
19867,mrauuuul,1417,340115,240,122,118
128003,oloffejkster,1242,298219,240,117,123
509620,patipati,1170,280826,240,102,138
507216,roman1984,1372,329343,240,131,109
3382,tomkowski123,1310,314580,240,116,124
537531,tromchik,1526,366299,240,182,58
169762,uchodzcy,1329,319159,240,117,123
524366,adima,1197,286133,239,101,138
21773,ajmpes,1336,319518,239,150,89
248338,andjan10,1171,279916,239,104,135
33075,arekstr,1259,301020,239,101,138
15219,bbartekk15,1277,305330,239,127,112
385658,bws7464g,1171,279927,239,92,147
2601,cmaciek,1388,331962,239,97,142
484585,cmg3605g,1251,299079,239,115,124
83,czeski89,1283,306858,239,118,121
30690,dudus78,1213,289997,239,101,138
191939,foresciak,1262,301683,239,135,104
143449,jowtek,1147,274349,239,76,163
31123,kamileko0014,1221,292007,239,112,127
576386,kierodino,1251,299004,239,115,124
571376,kmf6739g,1226,293099,239,132,107
58571,krystian2551,1389,332080,239,109,130
231280,lysy18susz,1082,258808,239,81,158
347403,marcinwolny,1281,306239,239,108,131
20505,nneila,1411,337422,239,140,99
90703,papadance,1402,335316,239,158,81
152514,rozwalilem,1923,459783,239,185,54
206014,spk2777g,1358,324693,239,135,104
116536,tuhord,1554,371573,239,125,114
130754,tylomylo,1137,271810,239,79,160
531872,adek783,1167,277767,238,117,121
288060,adzia1989,1190,283443,238,95,143
229675,anulexb,1184,281939,238,137,101
62951,bajerk,1078,256680,238,73,165
91040,dejdzioba,1569,373654,238,143,95
543687,gcc6372g,1413,336526,238,123,115
85262,imperialstroo,1197,284932,238,101,137
99809,julkatorres,1361,324100,238,150,88
567887,k5s,1902,452710,238,184,54
241993,kabul777,1255,298833,238,108,130
70609,kamilmistrz1,1190,283247,238,103,135
55830,karpik69,1008,240099,238,62,176
28370,legolas152,1096,260912,238,76,162
72897,marcinelite,1361,324112,238,153,85
496530,mercilessgirl,1384,329456,238,149,89
8809,misia3005,1129,268845,238,90,148
498250,nbt8856g,1282,305306,238,150,88
435712,nowakjbmnt,1224,291467,238,104,134
508582,podgryzasutki,1542,367049,238,110,128
67012,roksabor,1189,283145,238,122,116
43163,tomeck96,1216,289621,238,120,118
431089,truedenga,1247,296816,238,122,116
609074,wdk9026g,1326,315694,238,141,97
206287,wtg699g,1258,299469,238,122,116
38452,xxszymoxx,1223,291101,238,96,142
23997,aleche,1512,358466,237,142,95
104617,barthezz2,1417,335892,237,107,130
174179,bbp7188g,1164,276021,237,107,130
637232,cmm6642g,1198,284028,237,104,133
20201,gmp3790g,1418,336229,237,106,131
21791,grubytno,1376,326346,237,132,105
152866,ifx,1816,430401,237,154,83
21074,kamilhehe,1480,350855,237,157,80
500363,kdw4177,1247,295681,237,121,116
24811,lipa7366,1519,360115,237,141,96
426770,lozi101k,1194,283124,237,128,109
420022,mdp2497g,1348,319600,237,124,113
269703,mnia3,1409,334005,237,156,81
445644,mps5161g,1349,319833,237,175,62
66885,ollaboga,1329,315114,237,99,138
346493,papaj89,1497,354858,237,111,126
34203,pasjans67,1158,274519,237,109,128
231463,pawelexc,1249,296243,237,131,106
412350,pio82,1210,286822,237,99,138
408145,pkn5241g,1237,293379,237,111,126
414621,sqbany134,1150,272685,237,109,128
102001,tynaska,1248,295786,237,127,110
440216,wbk4240g,1141,270501,237,65,172
155219,ziutagola,1231,291841,237,116,121
123316,zlatan89,1079,255869,237,68,169
300344,19kicia10,1227,289759,236,120,116
374084,5minwygram,1361,321245,236,114,122
410634,ddd2051g,1371,323613,236,134,102
38634,energyyy,1385,327063,236,129,107
145216,fnk4780g,1516,357861,236,151,85
205465,gry,1376,324787,236,156,80
198481,h2p,1300,306895,236,116,120
219659,husar1987,1297,306179,236,132,104
141316,jaco5006,1169,275945,236,88,148
205133,jarko37,1211,285978,236,97,139
604459,kubera1986,1329,313651,236,149,87
138398,mpgoral,1271,300068,236,121,115
151038,oukast,1345,317642,236,103,133
102784,saturdayy,1366,322376,236,157,79
649547,smolarkus,1181,278843,236,107,129
13033,spontananakon,1371,323590,236,128,108
224508,square,1482,349903,236,128,108
253123,tustus322,1350,318627,236,128,108
21079,witekk29,1205,284522,236,104,132
281849,22pele,1525,358464,235,105,130
520848,dtn4936g,1284,301805,235,136,99
632435,dtw1104g,1621,381120,235,155,80
392229,elowerka,1359,319443,235,133,102
557384,fmb3040g,1214,285489,235,122,113
316442,goldenlife,1224,287644,235,97,138
11268,gottagofast,1333,313256,235,165,70
295364,huayra,1705,400784,235,143,92
158551,islandja,1550,364258,235,104,131
33,jadziela,1283,301552,235,112,123
312441,kfk8855g,1397,328363,235,142,93
135960,kubalina2002,1253,294636,235,136,99
107929,lvlenofglory,1930,453604,235,139,96
14802,malylitr12,1009,237260,235,54,181
13598,matek1996,1282,301410,235,107,128
59957,mrpresidentpl,1372,322532,235,166,69
90081,patrykmanutd,1443,339228,235,121,114
7161,rrobak90,1420,333861,235,142,93
409612,scp9081g,1201,282467,235,103,132
253269,ssf6557g,1545,363148,235,153,82
138675,szakal2525,1242,291975,235,125,110
346642,teqila13,1329,312529,235,53,182
63008,terayoo,1326,311704,235,152,83
255227,tmp6521g,1197,281472,235,109,126
1998,waakaacjee,1285,302164,235,137,98
573967,waldemaro1986,1471,345758,235,145,90
82316,woocash94,1396,328115,235,93,142
16950,andyy222,1431,335046,234,140,94
107244,forma69,1334,312311,234,124,110
475746,ggw4327g,1345,314864,234,158,76
14037,kmariusz1,1407,329277,234,91,143
380645,koko9221,1200,280925,234,112,122
473965,loksu,1310,306672,234,136,98
48931,melisska,1181,276532,234,98,136
5449,mozartmozart,1278,299198,234,111,123
535603,oopa,1672,391364,234,131,103
99804,ostatniwers,1492,349285,234,96,138
189340,psds5,1528,357747,234,145,89
32297,raf9999,1324,310016,234,116,118
331888,rudi221,1520,355723,234,202,32
103688,sokotsu,1623,379830,234,159,75
611572,tajny2,1169,273746,234,93,141
105228,tipol11,1319,308852,234,124,110
15245,tmecl,1632,382038,234,138,96
2294,wd2354,1320,308953,234,104,130
88712,acedia21,1140,265799,233,95,138
295336,blomwaza,1463,340993,233,149,84
375165,dawajnaring,1288,300281,233,107,126
178541,faceburger,1469,342410,233,133,100
71152,gazik24,1340,312277,233,128,105
363082,gks8021g,1163,271034,233,92,141
349605,ilj,1413,329400,233,144,89
610349,jestemslabyok,1395,325210,233,139,94
88503,jpna69,1185,276112,233,93,140
6319,kahaaaaaa,1403,326971,233,142,91
9802,karol713,1399,326126,233,88,145
533967,karol9292,1265,294910,233,87,146
125738,konyyo,1180,274997,233,113,120
103938,krolowatylko1,1364,317952,233,151,82
74721,krwiodawca,1622,378009,233,146,87
87010,kultures,1542,359314,233,130,103
531915,mpd444g,1235,287950,233,119,114
6225,paweu11,1134,264331,233,88,145
284985,pedroika,1327,309370,233,138,95
377922,png9747g,1403,327025,233,132,101
12683,prezesgrzes,1225,285644,233,105,128
187133,radek1233,1180,275122,233,100,133
92672,rz6,1117,260466,233,63,170
49892,sabik90,1644,383192,233,131,102
374546,sataniel,1447,337325,233,152,81
7685,shackazoom,1372,319820,233,133,100
1102,wamp22,1212,282620,233,111,122
580030,wcdam,1388,323614,233,86,147
86361,7demka,1691,392369,232,111,121
105142,andrzej038,1142,265059,232,94,138
650089,bds4989g,1268,294188,232,123,109
994,dajziemniaka1,1257,291748,232,97,135
10491,graferek,1163,270021,232,26,206
443707,karolq88,1315,305306,232,118,114
380195,kkn9302g,1147,266163,232,100,132
401887,krzys4444,1255,291281,232,119,113
122650,kubas780,1093,253654,232,99,133
586392,marcynnn,1199,278375,232,108,124
16532,niezn4jomy,1570,364353,232,132,100
56455,pogo90,1262,293003,232,138,94
247659,sosnowiec1981,1468,340584,232,141,91
495690,tkt9014g,1270,294675,232,127,105
386296,zakuu,2755,639178,232,120,112
1310,zapiekan11,1426,330949,232,136,96
288265,zark1,1248,289717,232,109,123
34669,buniania84,1403,324178,231,132,99
5258,dylanek73,1142,263975,231,75,156
237844,eragon99,1261,291350,231,141,90
5638,fifa14,1336,308635,231,139,92
566425,gretsch,1193,275643,231,104,127
236886,hiziol,1543,356467,231,122,109
58033,horiz,1423,328943,231,117,114
45298,klapsss,1353,312571,231,149,82
240238,lipinianka,1408,325341,231,188,43
3303,mimus2,1401,323695,231,178,53
298694,ms66,1498,346115,231,137,94
309895,narosek,1582,365453,231,176,55
481269,olgajestsuper,1105,255450,231,64,167
143135,ozner,1204,278182,231,99,132
602899,pfn6184g,1320,305043,231,136,95
318197,prekursor,1879,434175,231,152,79
55537,rafal9206,1362,314669,231,111,120
130502,ramzes2189,1114,257562,231,71,160
2201,rudyg3j,1601,369986,231,123,108
80933,silesaaa,2016,465871,231,126,105
6038,sk0crouzer,1501,346753,231,142,89
100720,skor7315,1533,354160,231,142,89
115168,supermisio27,1260,291262,231,133,98
90755,szym90,1125,260010,231,85,146
31005,tomek19741607,1272,294005,231,103,128
479952,vercass,1438,332394,231,146,85
487658,wukazet,1220,281824,231,104,127
633,yarai,2051,473806,231,180,51
226190,andziula2003,1123,258348,230,93,137
183447,atakdefensywa,1476,339596,230,97,133
516347,bmm9890g,1299,298879,230,131,99
561061,cgn4670g,1248,287119,230,127,103
31443,d95,1250,287608,230,102,128
326337,galactico,1353,311319,230,114,116
639064,ggn6617,1213,279072,230,108,122
391571,hardsell,1438,330885,230,125,105
183528,jekib,1669,384000,230,130,100
135076,kalinar,1286,295922,230,115,115
33167,klaudio27,1347,309827,230,132,98
429530,ladacznicax,1322,304135,230,106,124
39735,low1,1537,353536,230,109,121
32486,marcinlary,1183,272161,230,72,158
451364,mdn5452g,1313,302121,230,151,79
329089,nowyprogracz,1553,357392,230,149,81
77377,nuta08,1546,355611,230,133,97
180285,przegram2,1410,324480,230,131,99
568209,rafal5,1674,385182,230,138,92
53406,speedcenter,1254,288484,230,109,121
179326,szwagerrhinio,1319,303509,230,134,96
415989,tpb9428g,1441,331521,230,140,90
31181,arek097,1233,282364,229,128,101
360,ariczi88,1411,323196,229,121,108
149501,boskieusta,1583,362605,229,124,105
235978,cinek1977,1245,285164,229,118,111
20934,cyrki19,1345,308226,229,124,105
567753,ffc1434g,1174,268948,229,106,123
247298,fgn7500g,899,206019,229,3,226
304929,fkt7884g,1197,274291,229,86,143
384311,frustra,1904,436189,229,166,63
456876,gbm1302g,1053,241279,229,54,175
603182,hejkej12,1415,324184,229,148,81
575770,ilmostro,1521,348495,229,127,102
614495,kkw9167g,1333,305482,229,147,82
16544,konniez,1364,312407,229,134,95
21964,kornel120,1292,296004,229,137,92
167,kt88,1250,286463,229,121,108
155268,lstopa07,1244,285077,229,118,111
53921,marcinsiwy24,1236,283045,229,95,134
308706,mrschmitz,1402,321166,229,134,95
61689,pissar89,1267,290173,229,116,113
27649,placek2811,1226,280932,229,102,127
652142,pmk7349g,1379,315970,229,142,87
393803,pom222,1434,328401,229,130,99
239674,sadaevz,1274,291883,229,115,114
557733,trutdikaslu,1523,348913,229,171,58
298854,wiesiek4,1064,243786,229,63,166
12453,yetroo,1356,310743,229,160,69
102954,asialat6,1419,323750,228,162,66
526143,cocku,1217,277477,228,106,122
193250,danielwojtak,1277,291256,228,151,77
94304,dominikaa1314,1425,324969,228,180,48
187658,eczo,1369,312255,228,126,102
510988,fidzetspiner,1311,298959,228,171,57
135794,isio79,1130,257785,228,89,139
172660,kaskadaw,1545,352436,228,153,75
39284,kinga09l,1299,296364,228,110,118
5002,lukaszz1982,1281,292242,228,123,105
257414,margesimpson,1435,327210,228,108,120
328853,marz27,1492,340279,228,135,93
118394,mich1112,1203,274499,228,86,142
44263,moniaaa002,1155,263553,228,100,128
381740,mpf7938g,1358,309694,228,111,117
540474,nwm9722g,1225,279308,228,120,108
251174,raul7,1164,265507,228,27,201
41708,savioo,1734,395431,228,115,113
15725,slimed,1241,283013,228,116,112
213585,szlona87,1340,305739,228,76,152
101621,tomekzpodlesia,1813,413501,228,96,132
145201,waandaa,1178,268759,228,92,136
400481,wkn842g,1266,288794,228,121,107
147769,wojciech8,1260,287322,228,116,112
8892,wstrzasniety,1190,271352,228,102,126
238662,xxnatka,1152,262740,228,87,141
8394,abybyc,1635,371328,227,90,137
6110,agniesiaaa63,1229,279029,227,97,130
154873,ansferek,1139,258729,227,84,143
17089,areek1975,1365,310064,227,150,77
359042,armando89,1622,368254,227,127,100
531925,cnc4571g,1277,289881,227,129,98
189143,cronaldo61,1428,324382,227,176,51
511204,dbt9779g,1293,293520,227,134,93
367360,erta,1170,265770,227,92,135
22186,frankzane4,1217,276377,227,120,107
192718,iluminatty,1586,360177,227,127,100
144210,kzdz,1198,272111,227,98,129
324214,landino,1163,264033,227,86,141
526162,nkf2099g,1358,308325,227,149,78
292823,nnw9788g,1310,297533,227,136,91
424389,nyxluna,1269,288281,227,156,71
65631,pawnosz,1250,283903,227,120,107
257369,rodick,1316,298861,227,97,130
47111,tycieciu,1473,334552,227,131,96
400879,zdzichusprezy,1368,310727,227,107,120
62541,1pistolet1,1409,318644,226,114,112
54297,alwinos21,1274,288078,226,112,114
376501,buniek93,1129,255337,226,101,125
327209,carycapuna,1127,254790,226,81,145
247583,cfm8151g,1390,314319,226,171,55
155379,ciaryp,1161,262450,226,86,140
32575,dagusia1992,1156,261464,226,92,134
423825,dfk8003g,1381,312149,226,141,85
664027,inkognitoo,1469,332119,226,120,106
357243,kasia13kato,1516,342643,226,119,107
31714,kierda1,1294,292469,226,142,84
19811,klaus4,1640,370723,226,111,115
373109,krimestory,1416,320059,226,124,102
108009,krst2000,1289,291493,226,130,96
386827,ksc3240g,1418,320476,226,133,93
373578,mbw112g,1297,293170,226,126,100
468416,milena8891,1148,259595,226,81,145
38672,misiok97,1149,259858,226,86,140
302286,paawelll1,1127,254765,226,91,135
74114,pietruszka3,1177,266027,226,109,117
549077,polak19,1431,323413,226,192,34
388787,pom111,1554,351267,226,168,58
618234,progres,1877,424342,226,163,63
588910,serdelkowata,1132,255890,226,83,143
413980,szymonlegia12,1451,328056,226,206,20
545848,tcg3972g,1102,249219,226,43,183
105487,wh1sky,1634,369499,226,153,73
99149,16wicher,1255,282510,225,114,111
6346,adamlech,1254,282300,225,109,116
88382,chlopirejmont,1411,317656,225,120,105
137532,darek235,1060,238677,225,69,156
467213,dariush74,1404,316123,225,129,96
603138,gizer,1213,273045,225,98,127
257189,jack250,1325,298308,225,117,108
303031,kasiapl123,1333,299968,225,150,75
221392,lioneel,1364,307096,225,150,75
51824,lukw58,1420,319528,225,173,52
173424,marioncat,1380,310578,225,120,105
486241,mgd3307g,1254,282177,225,114,111
69616,mikonew,1268,285323,225,137,88
639245,onaa94,1334,300218,225,121,104
46465,qba86,1357,305517,225,113,112
383085,rogalik26,1363,306883,225,167,58
13812,savagra,1221,274808,225,84,141
588753,sdw964g,1468,330419,225,152,73
157681,skm483g,1556,350267,225,161,64
158150,skortomasz,1511,340126,225,142,83
649745,skp5522g,1373,309145,225,104,121
361002,smf166g,1450,326306,225,117,108
429866,tbk3091g,1532,344730,225,113,112
1289,tom1980,1389,312678,225,152,73
515917,wkd939g,1199,269799,225,87,138
423172,ziomalekyt,1316,296285,225,153,72
103328,0821,1503,336712,224,115,109
94392,agniecha167,1240,277783,224,129,95
510264,agnieszkalols,1346,301712,224,164,60
229749,chab5,1543,345666,224,142,82
404447,cienki3,1488,333432,224,146,78
498358,ciosa,1727,386940,224,141,83
147098,donutt,1309,293230,224,125,99
457414,fdw2581g,1363,305437,224,145,79
619706,fks8542g,1559,349410,224,171,53
4300,hadeass,1463,327857,224,118,106
453263,idzmniestad,1421,318380,224,129,95
70523,jona4,1321,296043,224,133,91
47200,kcw1412,1135,254268,224,64,160
475494,kkm6419g,1358,304244,224,158,66
14015,kolman66,1258,281955,224,123,101
775,krzys4456,1285,287944,224,107,117
22998,kubachan,1549,347075,224,132,92
50533,lopekkk,1206,270214,224,108,116
5600,markdee,1924,431170,224,135,89
505404,miaumiau44,1356,303771,224,133,91
96277,mugur8000,1384,310188,224,137,87
309692,petyfication,1293,289756,224,130,94
550529,ppf9367g,1234,276539,224,122,102
1636,qcia,1412,316488,224,117,107
1041,sobok83,1384,310051,224,101,123
599685,sziszkebab,1295,290122,224,133,91
168242,ttjulia,1282,287301,224,125,99
596220,wdw6550g,1119,250823,224,82,142
80496,xxpatka92xx,1195,267739,224,94,130
386010,z0kz,1691,378827,224,142,82
600893,zetor7011,1108,248381,224,32,192
678,andreas1983,1357,302634,223,121,102
369419,bartek1221,1223,272763,223,121,102
1672,bober2115,1427,318254,223,135,88
490577,ctd9574g,1174,261812,223,88,135
23411,darknoise,1375,306783,223,139,84
302628,dkw1706g,1201,267870,223,112,111
512506,dsp3608g,1137,253658,223,77,146
279855,fotbalogicx,1301,290239,223,93,130
358858,fst4323g,1200,267804,223,107,116
1948,gaga3333,1221,272436,223,87,136
35337,gnojek02,1254,279813,223,142,81
25211,juberek1,1307,291471,223,154,69
159161,kapazycia,1342,299465,223,113,110
307333,kubagawron,1198,267159,223,110,113
3535,liviusz,1365,304572,223,130,93
91365,piti17,1268,282956,223,127,96
21494,proxxon,1463,326342,223,165,58
534206,radoxpakerox,1276,284686,223,133,90
114247,robik01,1279,285371,223,79,144
51,siatkarz9002,1361,303512,223,132,91
514769,themystez,1354,302012,223,170,53
89879,tomek9832,1234,275230,223,111,112
18028,trolas90,1201,267955,223,80,143
136390,uujostwo,1615,360145,223,150,73
29561,xellaax,1308,291841,223,164,59
335540,bmwe46mp,1248,277082,222,101,121
29245,catoblepas,1740,386381,222,149,73
35612,dana845,1181,262220,222,105,117
571386,fdg9156g,1377,305763,222,136,86
1442,fsj9795g,1170,259751,222,88,134
278,gkunibert,1232,273531,222,111,111
420478,gpm8368g,1194,265178,222,91,131
268102,ina91,1052,233755,222,44,178
190468,karlosraw,1175,260897,222,100,122
2526,koliber44,1292,286950,222,111,111
35048,lukiploski,1422,315769,222,102,120
553675,lunarlapis,1210,268776,222,104,118
413826,magdalena24,1558,346083,222,138,84
61046,malamalpa222,1277,283654,222,109,113
91491,mic136,1159,257347,222,89,133
481544,mmk6029g,1430,317603,222,114,108
252194,mtn8397g,1431,317903,222,115,107
5769,o2o,1686,374460,222,135,87
232726,olusina,1170,259919,222,104,118
247209,pmb9619g,1501,333387,222,109,113
298535,pom4,1464,325115,222,130,92
22377,ryfix,1341,297902,222,107,115
18998,sendog,1480,328693,222,144,78
13187,simbo,1363,302664,222,102,120
93029,skinhead14,1314,291774,222,98,124
89310,skipper1234,1305,289896,222,150,72
2309,thomson96,1328,294977,222,120,102
27344,toudixodwx,1347,299103,222,125,97
398655,treekey,1219,270785,222,102,120
173096,vivadab,1550,344131,222,124,98
196529,walker88pl,1263,280554,222,112,110
514562,wbg2059g,1299,288560,222,115,107
184905,91xx91,1533,338912,221,157,64
207577,agaopole91,1285,284033,221,112,109
155635,antyfutbol,1348,298000,221,123,98
127324,bobisilidka,1354,299256,221,151,70
312922,buliczarny,1167,258087,221,104,117
168212,cfk5929,1272,281163,221,123,98
310817,cgf6243g,1363,301297,221,138,83
12803,daszrade81,1392,307705,221,133,88
55424,fosateam,1393,308025,221,108,113
6131,gkuba,1401,309814,221,134,87
124943,grzekaj29,1304,288233,221,92,129
459675,kcw3163g,1449,320353,221,126,95
407687,keleti1912,1382,305612,221,158,63
271918,kfp8315g,1340,296268,221,122,99
11262,kynio76,1340,296230,221,103,118
302279,lalandan,1518,335539,221,158,63
131101,majorlazer,1379,304838,221,138,83
230764,marioelie,1326,293127,221,135,86
217033,mierniak,1510,333844,221,119,102
64638,mikito,1321,292027,221,125,96
14546,mondraola,1407,311092,221,110,111
49457,nemcio,1376,304283,221,116,105
646588,npw5561g,1072,236951,221,43,178
454067,olgaandrzeja,1205,266464,221,103,118
333984,pamela131,1250,276384,221,113,108
335333,pbt838g,1205,266390,221,97,124
247302,pioterloter,1472,325507,221,221,0
552874,rafal3544,1299,287298,221,138,83
267189,silver8022,1225,270728,221,117,104
329489,stanley5m,1228,271404,221,94,127
32090,takabiola,1277,282307,221,117,104
184143,tancerkajolka,1347,297762,221,101,120
102540,tmc8941,1171,258935,221,104,117
30334,verd,1369,302616,221,106,115
40897,wiolcia0704,1409,311448,221,155,66
67134,alodek1,1281,281907,220,120,100
7486,baxy123,1351,297223,220,132,88
16439,bongo,2107,463603,220,181,39
24042,brainiiac,1350,297047,220,94,126
104335,dark1314,1190,261954,220,87,133
361959,dmn6961g,1199,263872,220,107,113
340167,dnw4459g,1317,289864,220,136,84
15403,dudusrgw,1099,241952,220,70,150
315048,esolga,1278,281170,220,135,85
626218,gfs6989g,1401,308327,220,135,85
6028,gizbi,1370,301575,220,110,110
490376,gnt6278g,1190,261812,220,116,104
23067,hellsoul,1997,439509,220,135,85
14279,kruqw,1638,360489,220,126,94
615791,manderaa,1249,274858,220,112,108
111042,marcinzyszk00,1290,283870,220,127,93
618835,pbf1635g,1260,277388,220,99,121
527134,pbw1003g,1293,284475,220,122,98
274462,rbaggio18,1371,301804,220,111,109
475784,smt172g,1070,235577,220,59,161
81602,vox97,1206,265385,220,93,127
119267,wafel1921,1152,253538,220,82,138
345265,zlatanibrah,1545,339906,220,127,93
26153,adamspadam,1407,308175,219,142,77
30712,adisem,1194,261577,219,87,132
689,armiawisly,1356,297052,219,140,79
125872,dard20,1432,313678,219,149,70
515447,dzyndzynio,1496,327771,219,139,80
250651,f2501,1485,325235,219,116,103
159427,grub0daje,1746,382564,219,138,81
450029,hardos,1567,343211,219,166,53
4199,jacus15,1217,266549,219,115,104
136203,keray,1424,311931,219,138,81
391855,kiperek80,1198,262549,219,107,112
122593,kry5tian,1408,308437,219,129,90
86034,lajon0wy,1479,324077,219,136,83
119713,lordofwar00,1397,306034,219,111,108
337621,lowiecanin,1306,286212,219,97,122
370472,marcin6567,1151,252243,219,92,127
524681,pgg7997g,1305,285922,219,152,67
2706,rojaldrims,1496,327803,219,112,107
548211,ronaldo12pl,1337,292957,219,149,70
637283,spk2691,1127,247030,219,69,150
534729,verkv,1086,238021,219,72,147
130612,wielkiszu86,1272,278575,219,120,99
3380,zarazapis,1177,257834,219,79,140
216,zdenek1212,1388,304004,219,101,118
171159,adimd,1477,322203,218,116,102
257802,ballas001,1366,298002,218,156,62
578063,bbqql,1631,355573,218,124,94
66409,doba13,1414,308315,218,114,104
624535,drgogle,1444,314929,218,105,113
428728,fdw6921g,1483,323400,218,148,70
116102,fsg8328,1202,262178,218,101,117
303560,gabro1214,1198,261167,218,96,122
558882,graffik,1219,265859,218,100,118
123995,grizzlyrobal,2000,436023,218,102,116
116194,gtyl,1397,304552,218,98,120
553604,jakistam,1365,297626,218,144,74
177986,kaj66,1322,288359,218,118,100
558,klad,1803,393134,218,100,118
3607,kolek1112,1156,252018,218,81,137
207273,kris899,1403,305956,218,114,104
352296,kuchar199,1187,258895,218,102,116
475587,mandala,1283,279872,218,106,112
343898,mclarenf1,1296,282740,218,125,93
139053,purpureangel,1430,311949,218,118,100
15302,qqawer,1275,278118,218,118,100
387028,saltystan,1386,302219,218,103,115
94293,swk2387,1250,272618,218,125,93
573536,tdd4276g,1323,288440,218,114,104
186835,tgc3563g,1195,260679,218,97,121
475707,tss3379g,1376,299989,218,116,102
159666,uscher,1124,245110,218,76,142
362377,wojteksonta,1025,223518,218,44,174
543340,badyl1410,1363,295803,217,140,77
312451,bbk3797g,1225,265930,217,110,107
559371,byhoshi,1194,259169,217,100,117
79970,cinekxxl2,1356,294426,217,128,89
137644,costy70,1286,279157,217,137,80
729,cremaster,1248,271018,217,129,88
151619,daniel3711,1331,289032,217,132,85
102561,emaciek4,1380,299614,217,138,79
390441,fsf6211g,1221,264970,217,120,97
121949,jestemkoniemm,1654,359079,217,124,93
105817,kandi,1908,414099,217,140,77
212309,kdp8752g,1211,262908,217,89,128
218902,kondimistrz66,1218,264422,217,108,109
451395,krupek9696,1232,267553,217,111,106
74230,krydziora,1650,358185,217,125,92
3399,magda26m,1388,301199,217,108,109
371089,make85,1273,276304,217,113,104
43355,maximusq,1342,291244,217,102,115
93892,misia9088,1138,247112,217,70,147
279275,needforspeed1,1357,294548,217,116,101
528392,nwk8091g,1564,339574,217,136,81
17719,oliwia200,1170,253922,217,90,127
454344,pbw8147g,1343,291562,217,128,89
27628,perkusista17,1260,273584,217,95,122
575944,piedolewas,1650,358210,217,161,56
97259,piotrek1429,1287,279313,217,114,103
345261,pom1,1511,328020,217,172,45
218371,sebastian800,1204,261449,217,110,107
255946,ssf6396g,1328,288313,217,105,112
6224,tusjan,1222,265282,217,133,84
21018,vegetamajin,1638,355449,217,128,89
288919,vevvoo,1590,345166,217,180,37
7966,xfedora,1321,286769,217,139,78
386011,abecadloabc,1458,315003,216,70,146
85232,antros,1360,293857,216,116,100
2778,arq7623,1289,278571,216,93,123
59870,array4,1384,299016,216,106,110
203561,bnw9410g,1406,303856,216,100,116
238632,cdt5910g,1051,227093,216,40,176
494005,cgc3884g,1486,321164,216,127,89
518216,chihaha,1224,264506,216,94,122
194766,domix321,1247,269495,216,110,106
110456,dragrats,1851,399952,216,133,83
449165,drlg,1217,263050,216,95,121
92308,dzonyatak,1263,272998,216,82,134
107102,faraon12,1386,299390,216,155,61
21547,ganni7,1244,268708,216,110,106
469199,grosio94,1214,262366,216,156,60
242639,gtn3397g,1308,282681,216,139,77
55522,k034,1219,263410,216,136,80
70637,labra,1508,325842,216,122,94
87778,leon93,1108,239396,216,60,156
1599,lesiodg,1244,268890,216,89,127
189242,loreleika,1212,261942,216,126,90
44614,malyzks,1227,265135,216,107,109
69345,markoni200,1320,285291,216,116,100
534165,ntf891g,1372,296380,216,126,90
134451,pap3k,1274,275375,216,103,113
574061,pelek98,1230,265877,216,113,103
662762,pogromcajacy,1652,357036,216,152,64
3013,rastaban1,1424,307734,216,153,63
57288,riviva15,1652,356975,216,130,86
435121,sdb4301,1253,270694,216,122,94
89423,sokol205,1121,242178,216,85,131
114434,szczepan9,1360,293827,216,94,122
47230,theriosek,1636,353565,216,97,119
31440,adammek18,1151,247668,215,62,153
594450,beznickowiec,1544,331994,215,121,94
226709,cookiegumisx3,1335,287055,215,153,62
38994,frezdzer,1693,364115,215,129,86
644120,gregor1992,1264,271923,215,113,102
12332,j23j23jj,1267,272538,215,84,131
32,jackiejocker,1311,282075,215,119,96
172456,judasz1985,1451,312163,215,122,93
450563,kbala,1392,299443,215,100,115
409692,kmn7195g,1259,270711,215,103,112
561469,kraszz,1432,307968,215,114,101
599148,krvq,1686,362670,215,150,65
81076,lavinthal,1986,427184,215,134,81
469605,lebjestes,1396,300333,215,118,97
1449,lllooottt,1535,330168,215,99,116
13814,martynka2c1,1183,254549,215,85,130
620636,mbm77mbm,1292,277826,215,107,108
646589,mcc5558g,1283,275958,215,165,50
114043,misiaa117,1345,289247,215,141,74
245569,pck9333g,1386,297994,215,179,36
302347,pom18,1452,312338,215,124,91
387639,soodammn,1197,257381,215,104,111
520066,tbt6875g,1264,271923,215,104,111
43822,wx7,1367,294027,215,111,104
273524,yakuza36,1309,281442,215,108,107
34467,zbyszek841,1202,258437,215,111,104
123037,andiku123,1184,253557,214,98,116
192933,artuur22,1184,253451,214,98,116
241990,bdt9323g,1359,290948,214,135,79
44793,clarinet,2881,616717,214,115,99
130440,cytrynazx,1202,257406,214,105,109
240952,dawidk212,1403,300442,214,147,67
542809,dj44pl,1252,268107,214,123,91
147350,dybcio2350,1082,231582,214,68,146
116120,flightradar,1551,332009,214,167,47
303028,fsn1786g,1276,273212,214,124,90
482098,fwm5338g,1476,316055,214,146,68
347903,gbp219g,1421,304106,214,152,62
134877,hakerzlinkami,970,207778,214,25,189
125594,hotrace,1196,256059,214,84,130
624025,inkrementacja,1649,353007,214,145,69
50830,jednostronny,1427,305491,214,102,112
555213,lesio25,1200,256896,214,96,118
282135,maklovic,1365,292179,214,140,74
78287,masakra28,1512,323774,214,123,91
17040,mateusz7900,1321,282762,214,98,116
12017,mil17,1292,276521,214,109,105
276003,milusiatko,1366,292329,214,123,91
102044,misiaczek092,1348,288529,214,123,91
247980,pdsl,1313,281185,214,139,75
400469,pgd2587g,1421,304210,214,130,84
46890,samsauron,1358,290690,214,103,111
481268,sgn8652g,1295,277335,214,155,59
468226,sofia381,1117,239072,214,80,134
516521,szakul16,1216,260430,214,98,116
321465,tcw3024g,1224,262001,214,108,106
304359,tf1984,1366,292457,214,101,113
102075,tomekk9,1425,305040,214,110,104
8955,wieslaw1013,1325,283572,214,107,107
636857,xmva,1409,301639,214,178,36
13720,zimnazolza,1325,283690,214,142,72
244514,al1baba,1633,347870,213,120,93
36687,antoniii,1263,269230,213,101,112
169558,bartek2394,1177,250737,213,87,126
392306,czarnobrody,1589,338464,213,138,75
64827,daniels,1249,266062,213,124,89
354532,dpg1554g,1379,293773,213,113,100
277950,enveloper,1397,297689,213,120,93
559370,ffs4952g,1227,261549,213,117,96
203201,glupek38,1322,281629,213,126,87
648564,gregre92,1320,281228,213,102,111
250729,jlebowski,1592,339119,213,119,94
22549,krojtas62,1124,239496,213,71,142
176546,lukipoli,1407,299758,213,129,84
94077,majstrowa,1329,283206,213,121,92
613669,mfd8738g,1233,262809,213,94,119
161377,necro93,1365,290773,213,106,107
188058,nmn5082g,1286,274031,213,118,95
70036,ogoniasty25,1354,288500,213,146,67
36299,olciaolatosia,1127,240091,213,90,123
139156,paulinkaa122,1175,250335,213,94,119
625494,piwosz2018,1541,328404,213,103,110
4652,pkt2332,1253,267071,213,93,120
296369,punisheer,1446,308097,213,159,54
35077,reflex88,1201,256022,213,98,115
1744,smerf11,1174,250170,213,88,125
587342,tomy1977,1295,275934,213,114,99
267243,voiciech,1382,294389,213,128,85
476628,wnc8467g,1125,239642,213,82,131
550528,wtg8742g,1200,255712,213,97,116
642573,yamcha,1746,372060,213,152,61
47926,ziemniaczeekk,1185,252520,213,81,132
42738,zimnyyyyydran,1409,300264,213,165,48
111680,ajazxd,1898,402508,212,153,59
95712,damian5191,1213,257188,212,118,94
497740,dmc6160g,1251,265334,212,130,82
120244,erbe,1074,227735,212,80,132
202916,gbs6653g,1141,241924,212,86,126
7650,gladiatores,1187,251835,212,88,124
188478,gss6455,1155,244931,212,104,108
150591,iie5478g,1398,296553,212,104,108
318114,kcm242g,1311,277976,212,143,69
506855,kdm9729g,1267,268622,212,109,103
433693,kobotu,1279,271187,212,144,68
632573,lovit,1759,373020,212,155,57
88783,markus111,1241,263269,212,105,107
525124,mbp7772g,1203,255238,212,104,108
555446,nkt4812g,1191,252605,212,101,111
583442,nmt1627g,1246,264332,212,118,94
190127,nxa,1702,361009,212,129,83
22725,ol20ka,1315,278930,212,124,88
9965,olamarewda,1373,291090,212,130,82
116181,pan0tomasz,1546,327819,212,140,72
445704,psg9466g,1523,323068,212,139,73
331306,samtaki,1678,355820,212,125,87
52587,seebbaa,1618,343197,212,111,101
414295,tomenchy,1448,306990,212,106,106
379307,tws8167g,1188,251943,212,100,112
428203,wnk4669g,1191,252493,212,76,136
415670,zlesiecujesz,1881,398959,212,142,70
77126,about1001,1402,295965,211,79,132
99450,anna27,1232,260126,211,86,125
43933,barlak,1344,283732,211,103,108
73392,bcf1334,1361,287178,211,108,103
105550,bshop,1144,241493,211,77,134
149326,bulagracz,1973,416354,211,120,91
312968,ckc9796g,1451,306329,211,133,78
464202,cmg2713g,1522,321326,211,114,97
487548,dpt2054g,1307,275904,211,110,101
206951,dreadziki,1217,256926,211,111,100
488070,dws3737g,1374,290077,211,117,94
442684,golon15,1168,246558,211,86,125
3544,jarobne,864,182490,211,47,164
97821,karmilla,1364,287914,211,152,59
162811,kbm8446g,1146,241965,211,57,154
306576,kfc6532g,1188,250783,211,94,117
22934,kitelboys,1326,279837,211,92,119
143069,konhert,1198,252973,211,106,105
112,koxikbob,1515,319755,211,117,94
30722,kukac,1670,352388,211,123,88
124953,lukasztocwyl,1047,220980,211,42,169
1932,maxxes,1407,296900,211,94,117
236814,natalek22,1551,327428,211,142,69
7773,ninja83,1445,304989,211,146,65
576873,olejek84,1384,292054,211,152,59
445516,onapuchatek,1356,286192,211,115,96
117070,p0j,1716,362258,211,121,90
89318,pawelossi21,1204,254232,211,81,130
38347,polomaksi,1325,279656,211,140,71
27450,przemekwipler,1537,324516,211,114,97
180627,ratatatapika,1321,278848,211,82,129
364245,shukur,1280,270258,211,101,110
333169,tomek2288,1237,261178,211,114,97
72770,trewqaz9,1451,306303,211,110,101
41403,xrc,1776,374797,211,104,107
484737,zabiorecie,1313,277244,211,110,101
340676,143,1753,368198,210,199,11
106792,brutto2121,1243,261112,210,102,108
109185,cccp1981,1352,284087,210,124,86
498689,cfm491g,1275,267890,210,131,79
1015,createss,1313,275739,210,99,111
5265,czarownik555,1418,297939,210,121,89
122817,daruc1993,1431,300532,210,113,97
78971,majsterkowicz,1172,246161,210,96,114
64332,mariusz1988kk,1244,261284,210,95,115
173734,michal3462252,1210,254206,210,104,106
20396,misiapysiaaaa,1342,281885,210,129,81
18712,mixja2,1315,276195,210,102,108
437158,nst7924g,1565,328816,210,149,61
289896,ptm3523g,1197,251518,210,101,109
284150,schematy,1435,301431,210,89,121
78972,tictac100,1206,253429,210,114,96
524308,tnf9203g,1295,271984,210,121,89
671,treflopik,1293,271653,210,98,112
386003,tsztomek,1227,257846,210,95,115
106915,twt864g,1283,269591,210,127,83
646404,wcp349g,1447,303947,210,178,32
157293,wdw950g,1243,261213,210,119,91
216206,adolfo42,1287,268991,209,127,82
1143,adw86,1598,334178,209,118,91
592863,artur2121,1176,245933,209,81,128
107582,bartekcycu,1412,295272,209,110,99
648235,bbp4189g,1205,251871,209,116,93
272604,benlen,1415,295941,209,130,79
193900,bogu0305,1360,284427,209,131,78
113017,edekzwykly,1389,290349,209,121,88
446010,falbankowy,1517,317083,209,163,46
265040,fonzy,1190,248901,209,95,114
3988,gizmoksc1906,1321,276117,209,106,103
221406,groniak1000,1288,269242,209,108,101
308585,gtm9064,1367,285737,209,143,66
193899,karolinaklon9,1251,261546,209,93,116
486817,kkasiuula,1156,241761,209,82,127
325793,kolibert,1343,280836,209,149,60
624802,kz0707,1255,262386,209,107,102
84303,matiasx,1346,281427,209,112,97
48868,mckmako,1281,267904,209,92,117
272888,mdb6287g,831,173833,209,8,201
543248,michal0609,1284,268426,209,116,93
559125,miglanc,1460,305266,209,123,86
6012,mikpio,1168,244154,209,95,114
32783,mmmadzia,1408,294295,209,130,79
79932,mmwsi,1533,320490,209,158,51
198433,nodi2408,1239,259139,209,116,93
272991,rudykonfident,1793,374801,209,182,27
15929,syciu7,1026,214561,209,66,143
649052,szurka,1165,243524,209,90,119
50186,wsk232,1626,339973,209,128,81
23364,9dzidek4,1319,274465,208,120,88
2635,adrianjest,1193,248199,208,91,117
1755,alienlol,1471,306085,208,133,75
5913,artur91sdz,1299,270195,208,108,100
4868,beoulveamar,1460,303749,208,108,100
614869,brudas15,1276,265504,208,117,91
56779,ciencn,1346,280011,208,122,86
108658,dafitek,1181,245831,208,88,120
57756,ddd6066,1553,323030,208,125,83
403866,dnc7997g,1307,271868,208,114,94
285585,dpg6193g,1163,242016,208,74,134
536191,dzwieq,1271,264529,208,110,98
396654,emilkoxu2,1248,259647,208,110,98
74929,exulitu21,1292,268789,208,101,107
629479,gpc5406g,1261,262426,208,66,142
13863,guuraal,1319,274396,208,92,116
589945,indukcja,1615,335944,208,159,49
134868,intertomson,1394,290146,208,124,84
86291,klm1982,1276,265526,208,119,89
406508,kubwiki,1207,251139,208,110,98
269301,manfre30,1164,242233,208,69,139
455137,maracaibo0,1370,285133,208,111,97
20040,metoo89,1338,278381,208,124,84
408359,moledzki,1251,260252,208,86,122
366963,mtg2194,1290,268440,208,102,106
81367,noktrion,1854,385714,208,144,64
214662,nutysy,1268,263857,208,114,94
270271,ola554,1201,249849,208,111,97
65668,ozzmoziss,1376,286300,208,134,74
247857,pdm4170g,1314,273452,208,115,93
31080,preses0,1301,270679,208,115,93
336478,rkk00darek,1346,280157,208,115,93
175165,rob1020,1251,260290,208,98,110
202163,robertz11,1192,248119,208,81,127
166348,spajderkot,1754,365006,208,141,67
590649,tbb7636g,1164,242310,208,89,119
622872,tws9449g,1386,288296,208,126,82
607824,wbt3260g,1551,322663,208,152,56
578430,wsx69,1364,283800,208,112,96
78205,zyga240,1338,278389,208,132,76
65474,alfabetaxd,1222,253082,207,96,111
480439,baakoma,1266,262231,207,106,101
450841,bonok,1507,312071,207,125,82
86572,czlowiektorpe,1360,281535,207,128,79
188016,daniosh,1164,241132,207,77,130
11196,ewelina16295,1433,296821,207,111,96
98501,grandemilan,1321,273447,207,105,102
297223,gwf9131g,1392,288265,207,171,36
588344,haah,1384,286615,207,123,84
565572,hajdi29,1199,248320,207,99,108
39806,jim26,1440,298179,207,83,124
175143,kiniaxxx,1328,274901,207,123,84
438358,lgfk1995,1335,276398,207,160,47
358047,lookingirl,1501,310898,207,121,86
466670,lubiegracwto,1481,306679,207,132,75
291413,lukkas81,1082,224084,207,52,155
61579,marcello2001,1332,275761,207,91,116
6437,mdhouse,1462,302823,207,126,81
90848,mgk0swiergi,1215,251529,207,83,124
243500,paszka13,1209,250295,207,86,121
30825,pawel197,1248,258518,207,105,102
32276,polskawin,1547,320231,207,136,71
72414,rya,1318,272847,207,91,116
183309,sexiradwanska,1629,337360,207,135,72
1821,skipper997,1492,308885,207,119,88
135462,smukinsax,1205,249564,207,94,113
310253,sunnyhaze,1381,285950,207,100,107
76116,szaroll,1388,287431,207,95,112
170107,twf8988g,1228,254375,207,120,87
398638,123abc1,1243,256147,206,106,100
143525,aassddffgghhj,1264,260488,206,101,105
151705,alcatell,1450,298763,206,110,96
274891,arkadu,1282,264287,206,139,67
475862,bgt5968g,1330,274066,206,141,65
12286,bluray,1644,338668,206,126,80
24672,bulgariana,1948,401297,206,122,84
288822,cienki35,1040,214411,206,42,164
434840,dkg618g,1352,278519,206,119,87
688,gawrix,1406,289778,206,101,105
513930,gct6503g,1409,290261,206,107,99
450638,gkw4961g,1425,293577,206,202,4
77863,hmm86,1145,235969,206,76,130
38409,kaczekrocze,1261,259789,206,103,103
59692,kmicic50,1204,248144,206,86,120
391417,kondi101,1412,290979,206,124,82
299061,lolek056,1227,252873,206,119,87
38112,maaster89,1235,254559,206,88,118
58812,madworld,1459,300634,206,144,62
270605,marohinio,1346,277393,206,70,136
37352,mzalayeta,1481,305155,206,78,128
581365,nauszycimnie,1572,323921,206,110,96
643364,nbn4071,1232,253853,206,80,126
659,nita3007,1273,262407,206,91,115
93532,olla1211,1250,257636,206,101,105
50823,rafl1234,1266,260957,206,104,102
53228,robal852,1437,296086,206,129,77
83543,sebastianw21,1452,299177,206,109,97
204125,sensivity,1427,294076,206,91,115
130055,skortoma,1548,319028,206,130,76
283651,spk5320g,1389,286221,206,124,82
105965,thanks2shogun,1255,258655,206,110,96
97144,w0w0,2539,523229,206,146,60
453411,werotoksyna,1206,248450,206,87,119
250846,wkt3284,1161,239198,206,79,127
14583,0ralnydzikus,1685,345457,205,124,81
227203,1nonna,1273,261130,205,116,89
2533,7row7,1378,282583,205,86,119
334624,bartekpwl,1381,283275,205,121,84
201293,bombelek33,1303,267204,205,107,98
461181,cukrowyburak,1235,253287,205,111,94
5205,czusu,1403,287626,205,95,110
9311,darkboy7,1415,290273,205,102,103
515264,dkg5481g,1304,267463,205,105,100
14805,faeton1986,1374,281863,205,100,105
492355,ftp6181g,1229,251951,205,109,96
4440,integration,1468,301069,205,121,84
104395,kloju123,1267,259760,205,110,95
43365,marcin33363,1255,257322,205,117,88
84877,mrskejt,1384,283903,205,110,95
234450,nati1298,1416,290474,205,184,21
485960,nethersiss,1357,278364,205,127,78
435342,nik000s,1222,250522,205,104,101
143940,nsc2311g,1238,253933,205,96,109
185565,rasdfatzy,1476,302765,205,116,89
21452,scobek12,1155,236918,205,78,127
538510,ssg2124g,1349,276680,205,125,80
4318,timon88nh,1221,250490,205,103,102
315397,ttb3021g,1275,261384,205,103,102
356866,zbigniew6969,1103,226115,205,80,125
94448,1marcik,1248,254721,204,86,118
100393,aaaam,1323,270061,204,120,84
376598,alejajka,1113,227226,204,71,133
75146,ansibl,1420,289781,204,138,66
604762,antypoo,1234,251836,204,99,105
351665,bwt3461g,1265,258080,204,106,98
1695,degoutt,1365,278551,204,106,98
433013,fpb1079g,1116,227815,204,59,145
97786,fsdgh,1566,319563,204,136,68
175774,glodnykojot,1271,259302,204,115,89
646661,harpagann,1809,369143,204,159,45
586510,hernobern,1192,243300,204,94,110
15068,huliomorales,1355,276548,204,122,82
337721,kiniolo1,1344,274291,204,147,57
189304,klaudia2772,1070,218387,204,147,57
369463,kotecki17,1250,255141,204,106,98
425409,kts7184g,1489,303759,204,182,22
2369,letmeknovv,1937,395160,204,124,80
551112,maagdaaxddd,1198,244529,204,102,102
50571,michal781,1393,284184,204,142,62
536027,mmn7623g,1508,307661,204,95,109
293783,mrraus,1238,252651,204,109,95
397121,najwiecej,1579,322234,204,167,37
168568,nwd7800g,1391,283793,204,122,82
136921,pilkowygamon,1761,359347,204,179,25
352025,poisongirl87,1179,240595,204,96,108
633471,qensheimer,1456,297174,204,141,63
109871,scypiory,1457,297403,204,168,36
114806,skomplikovany,1649,336569,204,108,96
5857,szkolnik24,1368,279229,204,99,105
475685,ttb6823g,1395,284713,204,116,88
402853,zuza0,1175,239713,204,97,107
167142,88majster,1284,260826,203,113,90
259831,aap0,1486,301788,203,108,95
3731,aleksander825,1255,254862,203,94,109
87649,aovoa,1692,343488,203,133,70
79842,bati1357,1358,275742,203,135,68
59240,ccsccs,1332,270543,203,90,113
492629,cpn5812g,1154,234292,203,74,129
195126,cwb6198g,1308,265622,203,114,89
6920,dannymakiao,1118,227097,203,79,124
3055,eztaz,1282,260425,203,45,158
271238,fwg7797g,1346,273306,203,99,104
36325,gosia6661,1217,247214,203,77,126
45246,halls007,1332,270481,203,123,80
263935,huges17,1236,250935,203,110,93
404999,ikamikazei,1362,276678,203,154,49
305266,kantarella,1169,237391,203,81,122
299276,kol92,1304,264808,203,100,103
308928,lc980,1268,257524,203,109,94
34376,maciej100vdf,1428,290057,203,119,84
231448,mdc6290g,1441,292667,203,121,82
273539,ndk6945g,1458,295985,203,110,93
91508,olcia1121,1079,219124,203,77,126
18548,piter1988x,1533,311400,203,94,109
577781,qt123,1556,315903,203,164,39
254729,rolniczkaszuk,1349,273940,203,105,98
86597,ryl1987,1256,255111,203,89,114
381141,snt8825g,1290,261922,203,115,88
107143,struzesiu,1375,279152,203,146,57
317703,sympatyczny9,1340,272055,203,105,98
12834,szato33,1336,271249,203,128,75
616309,tfmorginal,1173,238304,203,97,106
209856,volvfan,1251,254099,203,105,98
625,wolineq,1222,248249,203,112,91
310371,xtrader,1563,317434,203,126,77
95957,yarobi,1269,257707,203,106,97
440512,ziik,1598,324433,203,128,75
42859,1kraken1,1293,261300,202,120,82
19820,94kopacz94,1271,256813,202,105,97
454068,andrzejolgi,1240,250650,202,113,89
41126,bogo563,1003,202610,202,11,191
506988,borghetti,1243,251234,202,96,106
437605,cdd1628,1261,254891,202,121,81
2658,chrism14,1338,270419,202,105,97
172552,cienkijestem,1330,268734,202,111,91
26050,dan8012,1284,259483,202,121,81
424610,dbt3926g,1293,261293,202,117,85
357265,devild0ll,1794,362517,202,162,40
500421,dgm8376g,1369,276557,202,118,84
2332,falus91,1444,291718,202,97,105
29552,fialek4,1238,250231,202,101,101
343741,gng2378g,1268,256189,202,102,100
6668,harry998,1632,329748,202,125,77
617830,juleczkaa10,1355,273877,202,100,102
420693,kizia84,1284,259448,202,104,98
52238,ktorychetny,1419,286732,202,104,98
298853,malgorzata195,1252,252988,202,145,57
246695,mmzorro,1226,247825,202,102,100
252474,nct9967g,1183,239021,202,79,123
603518,ndn8104g,1391,281016,202,120,82
89197,pikdzik123,1087,219659,202,47,155
95268,piotreksasak,1162,234727,202,81,121
46164,psp4242,1339,270645,202,105,97
7240,ronin88,1470,296945,202,109,93
44487,sandri2,1197,241955,202,102,100
53257,soniaczka,1490,301063,202,100,102
166369,szwinka,1351,273053,202,85,117
47730,tom2leszczyny,1157,233856,202,77,125
81727,vektroza,1304,263598,202,115,87
132940,wrxstisubaru,1619,327227,202,113,89
6143,xrate,1458,294621,202,95,107
304422,xxxvvvxxx,1418,286452,202,112,90
280693,zakalecmuzgu,1210,244444,202,106,96
400650,zlotakura,1345,271857,202,103,99
26063,2denis,1250,251259,201,84,117
447502,blondihehe,1118,224817,201,76,125
364283,cdg934g,1535,308651,201,110,91
181069,danh88,1267,254692,201,116,85
58174,dbam,1935,389096,201,151,50
91269,grzesiu33,1260,253289,201,102,99
490950,honeybabe,1160,233352,201,82,119
166609,jankes051,1290,259381,201,119,82
185527,kft2053g,1394,280220,201,106,95
23453,kibicholandii,1253,252017,201,86,115
212961,kijwokomarcie,1247,250696,201,92,109
249928,krzysiek1213,1080,217255,201,54,147
49822,kussyak,1147,230684,201,92,109
53,matadler,1412,283944,201,75,126
316071,mbs3643g,1377,276906,201,118,83
516741,mfp8251g,1299,261117,201,109,92
184118,mobutusseseko,1901,382103,201,173,28
442752,mpf6817g,1462,294032,201,130,71
135636,namidanokuro,1123,225834,201,63,138
632526,ncd4941g,1304,262105,201,106,95
564847,ostraasia,1461,293825,201,112,89
3655,patrykp79,1402,281817,201,100,101
421296,patyssiek,1456,292822,201,157,44
95571,rysiud,1386,278599,201,114,87
3378,slonihno,1297,260851,201,100,101
605223,suga,1409,283290,201,90,111
362223,uf0,1649,331615,201,119,82
568748,urokmarcelink,1537,309087,201,119,82
26385,vovka5,1565,314760,201,101,100
269636,xxvxx,1412,283872,201,124,77
5927,1124ja,1295,259189,200,119,81
23075,23oo,1680,336128,200,113,87
95239,aniulablabla,1221,244244,200,87,113
46656,bartekwo,1242,248403,200,122,78
634858,blondyneczkaa,1280,256103,200,99,101
1441,bumis,1400,280068,200,107,93
269369,cama2006,1648,329684,200,124,76
304041,cgp795g,1116,223342,200,58,142
111703,dlazabawy28,1261,252392,200,96,104
181899,fbf5153g,1419,283899,200,85,115
258089,filipeek,1667,333448,200,128,72
109140,jarljorg,1231,246368,200,98,102
121821,kalinka19i,1415,283128,200,117,83
59592,kamil621,1429,285940,200,105,95
353633,kkf4050g,1388,277742,200,129,71
79635,lulo7017777,1216,243325,200,92,108
4504,lvlonzo,1691,338308,200,110,90
212450,malamysza12,1564,312992,200,153,47
1707,milan,1637,327483,200,131,69
225849,mmaammii,1389,277890,200,113,87
88940,n0chyb4zl3,2198,439761,200,106,94
32149,nabanimistrz,1400,280145,200,67,133
583880,npf2059g,1454,290952,200,130,70
465800,ouity,1437,287488,200,124,76
261330,plutoprzegra,1620,324133,200,119,81
12433,pun3k,1397,279568,200,140,60
1078,qazar7,1598,319676,200,107,93
1381,slawo1506,1180,236030,200,86,114
81231,thurz,1496,299383,200,135,65
4369,twr8033g,1480,296007,200,120,80
241595,uzu,1458,291616,200,91,109
263731,wiesiaczek1,1404,280849,200,145,55
262491,yourheart,1455,291001,200,111,89
129435,ziomegks,1298,259722,200,123,77
381478,1a1a1,1449,288359,199,108,91
12014,ad357,1303,259411,199,80,119
276607,ban96,1290,256762,199,129,70
479232,cwk3163g,1218,242517,199,120,79
38,dizlle,1466,291832,199,113,86
601966,furman8511,1185,235911,199,65,134
424227,gawronpg,1305,259777,199,132,67
373633,hubert0777,1139,226795,199,73,126
7872,klaud88,1269,252633,199,89,110
119785,madziarozruba,1345,267665,199,103,96
258386,magdalena055,1102,219318,199,74,125
587806,mateuszg27,1341,266882,199,93,106
121525,miyoshix3,1277,254261,199,133,66
496196,mkb713g,1397,278181,199,127,72
1276,proki94,1368,272317,199,147,52
249169,s1piotr,1227,244235,199,99,100
190469,sarna1812,1185,235947,199,101,98
215607,sciacho,1179,234699,199,88,111
489460,sierpcsierpc,1170,233024,199,74,125
54264,smileee182,1126,224237,199,90,109
421716,snomek,1270,252777,199,76,123
215916,sztywniutko,1528,304121,199,116,83
170270,tgg1433g,1585,315416,199,135,64
356643,wbp3325g,1298,258426,199,98,101
22985,wlokniarz10,1564,311300,199,75,124
167542,xgangbangx,1785,355345,199,119,80
628485,zetipe,1208,240585,199,88,111
531411,zhadum,1465,291586,199,106,93
641686,zielony01,1388,276380,199,143,56
114705,albaniapl,1134,224563,198,87,111
1961,badkawasaki12,1186,234848,198,108,90
282879,bastekpl,1280,253580,198,85,113
507172,cmb998g,1085,214884,198,54,144
124177,dawidddd,1160,229713,198,79,119
246835,dnt9676,1260,249505,198,103,95
513352,dzika0rchid3a,1508,298746,198,106,92
180791,firestorm4,1232,244015,198,107,91
148330,herosiix,1441,285476,198,98,100
591053,kasiex123,1132,224256,198,79,119
8963,masterhaos,1544,305741,198,96,102
584442,mehiko,1406,278563,198,165,33
14698,mintcookie,1378,273026,198,135,63
496495,mya,1564,309848,198,132,66
42013,partyboy,1313,260068,198,111,87
610665,patryk7877,1213,240369,198,98,100
47190,picobel,1522,301433,198,114,84
37229,piotrek8846,1230,243718,198,111,87
182974,plus3plus,1293,256195,198,112,86
3836,qbofix,1231,243742,198,76,122
31734,spuchlok,1296,256772,198,102,96
519380,stn6422g,1249,247304,198,114,84
255706,takija20,1246,246888,198,86,112
9358,timelinex,1354,268153,198,106,92
486181,tual,1275,252511,198,106,92
98046,vanabes,1411,279412,198,116,82
57547,zyrafiatko21,1307,258871,198,111,87
122277,0p01,1558,306970,197,118,79
56953,7313,1370,269980,197,97,100
74168,amigo5,1245,245269,197,96,101
100843,analnywikary,1180,232575,197,81,116
362021,artur1990karo,1292,254621,197,96,101
197850,bikinifitness,1706,336082,197,178,19
453974,binnie,1384,272648,197,90,107
568778,bkk3796g,1269,250148,197,105,92
55177,bogseksdrag,1486,292909,197,151,46
641813,btg8890g,1187,234018,197,96,101
463162,dgd2563g,1175,231604,197,103,94
332401,dpf0214g,1547,304923,197,113,84
6001,dylek66,1124,221463,197,68,129
502756,dzikijackson,1199,236395,197,86,111
29082,fasolekk,1688,332565,197,128,69
2035,flowerpowerr,1274,251065,197,89,108
3523,grzegorz990,1382,272413,197,111,86
171789,ikor,1411,278122,197,97,100
101405,imprezaroku,1386,273142,197,104,93
5390,iskierkka,1201,236668,197,76,121
98911,kapulta,1484,292438,197,95,102
33079,kokatsw,1405,276969,197,95,102
199539,kwg6929g,1201,236716,197,84,113
596810,misiaa99,1139,224401,197,90,107
52038,nikejkaxd,1212,238854,197,83,114
601207,nsw9004g,1344,264923,197,99,98
130087,olcia2209,1275,251224,197,105,92
550808,ovia1909,1426,281056,197,103,94
174094,perfumkaa,1394,274675,197,157,40
338382,pingjing7tao,1619,318959,197,130,67
611549,pns7429g,1280,252198,197,111,86
373285,przemkox,1305,257196,197,113,84
199895,pudko,1253,247012,197,101,96
478431,pwn2411g,1509,297458,197,125,72
3601,qq102,1317,259585,197,89,108
451502,seciong,1319,259921,197,137,60
425553,shinyusha,1424,280703,197,107,90
475806,smn5272g,1373,270605,197,126,71
18437,szymon87ski,1215,239475,197,90,107
275486,tygrysicka,1261,248566,197,126,71
406446,vcurvionym,1403,276489,197,139,58
33659,y1l,1837,362017,197,129,68
109889,zajac17,1278,251939,197,129,68
166346,0000abi,1535,300967,196,102,94
38400,anqaaaa,1351,264873,196,76,120
19583,bblacha18,1306,256149,196,98,98
142403,bpawlak38,1212,237688,196,103,93
425055,cycolinka69,1501,294324,196,100,96
198886,demoon,1678,329051,196,130,66
371504,dkk618g,1297,254332,196,99,97
343860,dsc6468g,1272,249475,196,103,93
339675,dzem,1874,367481,196,134,62
9786,extr4gambler,1315,257926,196,113,83
621284,fsg5803g,1402,274837,196,109,87
172,goodgem,1247,244587,196,75,121
3358,kaska1502,1194,234193,196,56,140
318252,kwt6625g,1409,276273,196,140,56
65701,leszekflt,1345,263725,196,107,89
117017,lynyrdskynyrd,1956,383522,196,175,21
194681,majstersnk,1264,247757,196,89,107
338116,mani321,1469,288116,196,92,104
68802,masazyk,1348,264225,196,102,94
334172,niekolezenski,1793,351440,196,118,78
465178,no14,1418,278036,196,82,114
97448,pablosch,1204,236063,196,86,110
28635,piter860,1002,196535,196,29,167
7591,polamiesie,1853,363302,196,148,48
646500,sck6508g,1239,243025,196,103,93
245687,sgg8244g,1161,227582,196,72,124
87488,stickerbom,1477,289552,196,99,97
117328,toma7315,1548,303533,196,127,69
563,zabieraszmisn,1490,292156,196,88,108
175377,zawalisty,1399,274316,196,116,80
98840,aizensama,1232,240349,195,90,105
86466,andrzejedrek,1112,217025,195,61,134
389321,azbestowydaw,1609,313764,195,146,49
121780,bialas128,1362,265681,195,74,121
564217,bm188,1263,246386,195,135,60
322210,brylantx,1268,247436,195,83,112
45050,cichcok666,1256,245114,195,95,100
93318,d00ku,1256,244930,195,98,97
93853,daniel82r,1279,249514,195,85,110
186805,defisss77,1396,272252,195,155,40
327986,dmk5277g,1473,287369,195,124,71
154110,dominikai3,1324,258192,195,127,68
188747,elllis23,1137,221838,195,92,103
198953,eloponent,1214,236919,195,103,92
424388,emojay,1136,221640,195,63,132
238424,evillboy,1210,236064,195,91,104
479757,gmw9483g,1134,221320,195,71,124
484496,gremi4,1259,245561,195,113,82
22400,iineczkaa83,1107,215926,195,49,146
125809,kasiaxdxdxd,1026,200074,195,41,154
601500,ksm3091g,1412,275515,195,119,76
17170,martwygaciu,1263,246462,195,79,116
30100,matrynka48,1236,241022,195,101,94
471556,mgg8555,1357,264797,195,139,56
219494,namalujecie1,1231,240161,195,92,103
8034,o1992,1345,262329,195,124,71
2458,ogr99,1424,277696,195,119,76
39770,ozcriawta,1896,369760,195,150,45
178615,palemietowe,1513,295066,195,177,18
638669,patrykd2604,1203,234708,195,81,114
139549,pozytywnyr,1262,246179,195,100,95
643023,pps2789g,1195,233154,195,85,110
536583,ptm8177g,1154,225078,195,67,128
313768,pwm1808g,1332,259741,195,119,76
148889,razzor91,1170,228265,195,88,107
51155,robalis,1326,258604,195,133,62
40144,sebastiano271,1306,254753,195,99,96
184803,skortom66,1537,299844,195,130,65
4362,szartur,1237,241271,195,109,86
172970,tagisgame,1347,262815,195,128,67
170330,tewi,1421,277261,195,98,97
461589,tgp2841g,1315,256510,195,122,73
492866,wnw3725g,1282,250041,195,102,93
5588,wrzos782,1391,271395,195,85,110
195475,xxxsexxxx,1269,247515,195,104,91
214054,agaelo320,1388,269280,194,108,86
273945,antoniio02,1222,237187,194,108,86
425160,arbuz1997,1189,230834,194,77,117
78047,baqui,1404,272569,194,97,97
144503,chowderrr,1572,305067,194,108,86
485554,ckb4505,1353,262651,194,124,70
620386,cnb8930g,1368,265558,194,130,64
580,dawidozs,1419,275416,194,114,80
795,diegocosta123,1479,287106,194,108,86
482781,dsw7157g,1343,260704,194,127,67
75947,ewelajn10,1193,231621,194,86,108
143533,fsk8749g,1029,199783,194,54,140
530149,kamil1glik,1755,340659,194,137,57
187740,kamoenterpre,1254,243412,194,87,107
30916,karolinaaxx,1293,250850,194,87,107
403389,kck5367g,1294,251065,194,117,77
222856,kklauducha,1198,232452,194,77,117
623551,knn6604g,1440,279382,194,107,87
438762,krzysztow15,1312,254701,194,137,57
322783,ku84son,1129,219138,194,70,124
148796,liquidnitro,1549,300599,194,94,100
590455,mpt8151g,1384,268636,194,129,65
67026,mpuczkowski,1190,230976,194,83,111
295442,ms73,1531,297021,194,131,63
515937,pokasowe18,1752,340081,194,139,55
31708,przemcio14,1412,273946,194,99,95
53049,radwanekk,1193,231556,194,78,116
66626,savron23,1242,241024,194,69,125
514856,tgs7661g,1347,261390,194,128,66
564218,tinc,1126,218459,194,59,135
557659,tpd618g,1310,254194,194,88,106
402489,tpt6166g,1158,224830,194,84,110
371590,tsn3921g,1350,261922,194,125,69
209350,zbigniewgr,1118,217068,194,56,138
105514,zxc345,1284,249201,194,125,69
4385,alvares,1412,272559,193,119,74
950,ampularia,1494,288468,193,116,77
552657,anwfynofml,909,175521,193,0,193
19936,apci,1267,244700,193,116,77
639795,bandiot,1543,297863,193,103,90
901,dardar,1375,265542,193,97,96
41664,drw4387g,1285,248125,193,98,95
581946,fizol,1773,342364,193,130,63
636510,fpf7738g,1145,221136,193,58,135
425431,gpb4831g,1481,285924,193,122,71
642453,gramsobietu,1374,265368,193,109,84
317855,ibizka26,1338,258370,193,107,86
317752,inescudna,1321,255109,193,86,107
446417,kaizenxxx,1253,241860,193,109,84
418024,karolussx,1105,213395,193,66,127
503515,kicia1820,1343,259290,193,113,80
68722,kiryu,1588,306512,193,131,62
257238,knab,1298,250665,193,100,93
566063,knd5627g,1258,242895,193,94,99
637588,lilimarlene,1316,254052,193,113,80
43316,manieczki,1890,364821,193,141,52
16683,monterer,1288,248620,193,125,68
28920,moonika86,1378,266138,193,100,93
597291,piekar23,1281,247261,193,98,95
22753,prawicka,1368,264028,193,126,67
31951,senior117,1438,277536,193,86,107
551113,swagerjagger,1199,231595,193,95,98
105636,tolzjer,1713,330759,193,152,41
129192,tomek3203,1177,227290,193,79,114
633255,tomekw1983,1266,244459,193,120,73
290299,www6788g,1291,249240,193,111,82
138187,x56,972,187723,193,34,159
369302,zajcek044,1189,229539,193,96,97
85314,zarazegzamin,1695,327282,193,134,59
271192,zdechlegacie,1494,288462,193,122,71
416369,abisarika,1272,244382,192,108,84
9614,bruno850,1271,244046,192,94,98
23648,cienias10o,1614,309926,192,157,35
614298,danonek86,1466,281530,192,95,97
240836,dextarpl,1285,246802,192,110,82
429700,direttore,1351,259559,192,137,55
21453,dvhdhkszfcgsd,1234,237036,192,117,75
506268,gkb657g,1232,236632,192,96,96
241396,harcerka687,1327,254827,192,146,46
68138,kryhon87,1288,247397,192,93,99
29896,mar131,1444,277263,192,103,89
130561,mariuszwoj,1367,262617,192,114,78
916,marrrcepan,1340,257339,192,113,79
9280,mdiks,1285,246882,192,96,96
215766,misiaczkowi,1259,241906,192,104,88
242591,mnm7216g,1193,229185,192,79,113
238272,mrlukaszenko,1466,281645,192,164,28
110825,mrs0nutella,1502,288553,192,125,67
237657,offrider,1381,265230,192,137,55
216696,oto,1185,227696,192,73,119
56750,pearljam,1943,373193,192,165,27
501353,pkauto,1526,293117,192,105,87
7734,rafalch,1395,267970,192,127,65
12809,redevils,1375,264160,192,129,63
538371,tbs8286,1189,228304,192,90,102
609403,themazerunner,1768,339512,192,137,55
46639,weksel1,1264,242863,192,90,102
341388,wiolettkaxd,1057,203088,192,44,148
422560,wwb2687g,1247,239515,192,92,100
68935,daria1907,1275,243529,191,100,91
90307,dawarszawa,1351,258220,191,93,98
199992,dawidskyline,1204,230017,191,89,102
61346,donkluska,1258,240352,191,102,89
100100,dundun,1193,227945,191,86,105
384786,fayfusred,1506,287729,191,100,91
9794,fermivin,1232,235387,191,89,102
389889,freestate,1202,229610,191,87,104
610045,gbb7702g,1248,238492,191,99,92
11517,janekbilard,1152,220044,191,83,108
277983,jumpthenfall,1509,288329,191,106,85
70441,karol421,1130,215884,191,62,129
282385,klaso,1046,199897,191,58,133
24291,kosciarz17,1186,226612,191,94,97
124952,kujciwodbyt,1301,248509,191,155,36
89028,libciopipcio,1283,245086,191,63,128
481347,livebox,1322,252692,191,130,61
9393,lollek2000,1248,238460,191,93,98
100177,magdaa1909,1266,241922,191,101,90
304199,mora5,1068,204163,191,42,149
427697,norbs1,1341,256174,191,93,98
624011,oskarjus,1198,228937,191,86,105
248542,pawielll,1278,244266,191,108,83
217975,piastok,1078,205946,191,46,145
88341,posyptamu,1229,234914,191,70,121
83385,pumaa0969x,1602,305986,191,119,72
254533,rymcymcymcymc,1160,221566,191,87,104
178342,scyzoryk78,1230,235004,191,97,94
66286,szatanjanek1,1207,230656,191,94,97
175094,tmt8584g,1348,257647,191,136,55
4990,utgard,1417,270691,191,99,92
87731,wadz,1249,238725,191,68,123
207548,wiercioch,1243,237432,191,103,88
5136,ziele1995,1186,226548,191,88,103
383791,21adrianna,1207,229490,190,78,112
10190,boot19,1178,223866,190,75,115
364735,dawis954,1158,220040,190,87,103
188809,ejmama,1294,246045,190,89,101
294044,etnus,1428,271380,190,159,31
242338,ewrybadykupa,1281,243486,190,113,77
141123,fakajsieagata,1491,283410,190,105,85
37028,finarfinek,1364,259295,190,133,57
537103,griffiths,1572,298862,190,162,28
358133,grzesiekg,1362,258917,190,127,63
205705,icanfakubetta,1402,266502,190,87,103
214870,jupiler,1360,258585,190,135,55
73939,k0rczaki,1662,315816,190,116,74
512559,kasztelan8007,1399,265901,190,108,82
612028,komisariat,1272,241827,190,104,86
125421,lechp0znan,1748,332289,190,123,67
407250,mariusz1989,1356,257706,190,110,80
451287,mcg3377,1393,264761,190,118,72
608498,mcp2524g,1298,246796,190,75,115
132130,mnbvc01,1336,254014,190,99,91
11615,mocarz89,1329,252625,190,104,86
376891,mss2161g,1366,259659,190,105,85
129332,olsza,1267,240837,190,82,108
268053,omxomx,1148,218202,190,77,113
110291,pieknychlopak,1569,298131,190,103,87
85331,riddle,1882,357593,190,130,60
449164,rozpusna,1306,248309,190,96,94
128922,saruturi,1361,258713,190,107,83
111071,scotladnia,1304,247920,190,104,86
572385,sebaosw,1144,217381,190,64,126
179493,sexigirl,1349,256393,190,74,116
176249,skortom15,1536,291987,190,126,64
95191,stomatolog89,1736,329964,190,137,53
280446,tyx,1807,343349,190,167,23
531184,witcim,1306,248245,190,130,60
435290,zlaman3serce,1754,333409,190,133,57
125869,1105a,1476,278974,189,103,86
59981,adamdry,1176,222388,189,79,110
16621,balu112,1354,255962,189,122,67
233244,bazyl666,1413,267129,189,152,37
1275,blociu1,1414,267290,189,102,87
44883,blubo2230,1293,244560,189,109,80
3074,boroszek,1432,270779,189,97,92
364008,bumbumbeata,1035,195681,189,40,149
541164,cataleya01,1261,238362,189,105,84
2821,chemibeary,1330,251511,189,102,87
370815,cmn3038g,1220,230685,189,94,95
52666,czlowieczek7,1394,263554,189,124,65
5094,dzekin,1239,234350,189,84,105
591736,fpp9662g,1423,269079,189,145,44
426660,fsn924g,1270,240075,189,115,74
458248,horseshoegang,1553,293679,189,113,76
110562,jaspacja,955,180558,189,24,165
99569,jezior1994,1392,263162,189,100,89
315226,kasiula22,1178,222664,189,81,108
84423,kingusiaw,1244,235281,189,87,102
17143,klocbond,1421,268747,189,100,89
323947,konikprzemas,1151,217540,189,82,107
35376,ktototu,1109,209721,189,83,106
5841,mka50,1432,270727,189,161,28
552618,mmn5908g,1220,230643,189,69,120
183304,monikasroka,1682,317920,189,116,73
212785,nmg2937g,1258,237813,189,94,95
469552,padaczka233,1426,269599,189,109,80
255030,prossiak,1215,229703,189,80,109
17875,rozwalacz4000,1377,260440,189,82,107
444671,s2773,1476,279024,189,113,76
526845,sikora1987,1202,227332,189,81,108
268226,silwerakos,1183,223615,189,82,107
319085,tcf526g,1346,254567,189,87,102
12165,victor75,1252,236684,189,84,105
596375,vrughl,1501,283863,189,144,45
280364,wnc7768g,1334,252240,189,108,81
13403,zed32,1301,246051,189,111,78
40067,zrazz,1300,245811,189,86,103
285146,29o10,1575,296218,188,91,97
83047,adominik,1127,211917,188,73,115
532516,anoy,1378,259081,188,86,102
387916,ariel88,1310,246438,188,135,53
17145,artem,1400,263338,188,97,91
351844,astonenergy,1449,272539,188,127,61
63107,aurilos,1375,258545,188,98,90
121470,bartekksiadz,1282,241106,188,103,85
486354,bmw137g,1286,241789,188,114,74
203771,bolczenko,1182,222283,188,98,90
306916,fds2533g,1058,198962,188,53,135
416922,fif,1725,324423,188,121,67
567890,gdg8387g,1274,239698,188,101,87
169153,graczub0ss,1241,233406,188,88,100
490929,grubygnoj,1217,228943,188,116,72
1386,kaczuszka78,1459,274342,188,104,84
114229,koroder,1244,234006,188,86,102
105819,kotmariana,1350,253812,188,100,88
16158,kristofen1902,1139,214133,188,67,121
25436,maksmw,1245,234117,188,78,110
103334,maleymistrz,1359,255537,188,98,90
137259,mckura,1369,257449,188,95,93
111545,motylek28,1258,236653,188,86,102
306141,mystery1020,1029,193499,188,38,150
356865,nafing870,1182,222399,188,118,70
193268,nikitki,1404,264015,188,114,74
336619,noneknowhoiam,1468,276072,188,123,65
376579,polanko92,1133,213051,188,94,94
68299,pozytywna00,1109,208544,188,61,127
87564,puchatek04,1508,283579,188,147,41
360798,sarkasta,1526,286900,188,133,55
83592,sawwap,1379,259295,188,102,86
191675,skf5284,1174,220774,188,80,108
104975,skor1573,1504,282791,188,125,63
73100,solostar30,1056,198586,188,56,132
90513,villgefortz,1444,271631,188,93,95
228269,wrzesien19,1243,233870,188,95,93
141588,wsg7250g,1298,244025,188,116,72
4430,yyyuuu123,1356,255059,188,108,80
193069,ziombelson,1422,267376,188,94,94
481085,0053,1427,266956,187,130,57
130902,1maslak2,1168,218440,187,76,111
483640,akczelo,1515,283340,187,101,86
82356,andrzejryba,1305,244100,187,67,120
519359,boii,1796,336001,187,144,43
435513,calyn1988,1188,222165,187,73,114
212624,cnf5809g,1440,269322,187,114,73
100064,czapsiok,1167,218244,187,82,105
7967,dopmix,1260,235787,187,83,104
233469,grecia,1248,233517,187,81,106
67280,grzmot69,1328,248465,187,116,71
310384,hkitty95,1117,208970,187,74,113
631664,hubert186a,1225,229104,187,80,107
105075,jaczyk123,1234,230759,187,115,72
170036,kampel1,1146,214457,187,73,114
622339,kangur735,1259,235579,187,99,88
69919,kapelot,1248,233514,187,102,85
293100,kdb8168g,1532,286563,187,112,75
50664,kff1074,1329,248688,187,137,50
385938,kfs3859g,1409,263525,187,111,76
538,kgfmistrz,1442,269693,187,91,96
621504,ksf2322g,1323,247494,187,71,116
175090,kuklok,1192,222917,187,72,115
44232,luter1916,1514,283134,187,94,93
147771,malinowy1982,1092,204296,187,51,136
163703,marry0147,1213,226890,187,103,84
86080,mieturzeznik,2080,388993,187,106,81
319775,ohsoo,1244,232676,187,118,69
582299,omj,1649,308384,187,149,38
90815,pinkafluo,1610,301167,187,122,65
564933,piorun321,1409,263502,187,116,71
47199,pkp1095,1316,246124,187,140,47
474832,pms270,1285,240459,187,105,82
124725,pogonwezyska,1399,261767,187,108,79
118872,pumbor,1180,220703,187,67,120
22275,savorth,1373,256827,187,89,98
102394,slawek102093,1386,259281,187,107,80
659799,smt682g,1576,294771,187,112,75
215294,stt8730g,1276,238784,187,103,84
490379,szmysia,1762,329559,187,94,93
145339,tomskor27,1543,288600,187,124,63
537864,tutyj,1543,288682,187,141,46
103009,ujb,2028,379359,187,144,43
661851,wgc5910g,1284,240136,187,79,108
180305,xnnikolasx,1279,239331,187,115,72
635232,z0nda,1357,253937,187,109,78
594207,zlg,1535,287217,187,120,67
223283,zootech,1262,236133,187,113,74
661544,bjjmmakungfu,1488,276922,186,103,83
557548,bkd4228g,1384,257425,186,125,61
56352,bladek,1345,250249,186,93,93
135801,cisnienie1,1191,221579,186,75,111
192857,daxpl,1398,260033,186,94,92
297840,dfm2494g,1183,220113,186,76,110
259489,dulcynea182,1155,214913,186,92,94
637941,fbd3411g,1241,231003,186,69,117
193087,fisiu2002,1245,231595,186,93,93
247118,gng2672g,1168,217332,186,80,106
634760,goodnoc,1439,267740,186,102,84
391668,jajo17,1202,223572,186,91,95
1227,jm88,1483,275996,186,115,71
104847,joker17,1395,259647,186,142,44
53901,jumpooo,1350,251221,186,109,77
235508,juuben,1306,243039,186,88,98
588031,kamiloo389,1187,220956,186,75,111
7195,kamiltag,1329,247365,186,114,72
367262,kirtas,1505,280020,186,97,89
1395,komandos2008,1347,250717,186,87,99
184211,krecimigasie,1506,280268,186,110,76
235084,lechiawsercu,1391,258808,186,95,91
188043,mirskor,1521,283080,186,114,72
488204,pms8578g,1280,238084,186,134,52
34933,pyszczakczek,1299,241703,186,94,92
104715,replikat,1258,234022,186,86,100
507382,rympalka80,1374,255600,186,99,87
18491,szczepan2191,1283,238686,186,107,79
18319,tmd4965,1349,250985,186,124,62
562861,tomy7777,1253,233105,186,95,91
606648,ttc6311g,1366,254200,186,99,87
178570,vasyla,1650,306911,186,112,74
2681,vkp1,1310,243774,186,65,121
27356,woodypol,1195,222388,186,89,97
635367,yoongles,1424,264876,186,86,100
118851,3ndd,1388,256796,185,125,60
14861,adammiki21,1437,265863,185,116,69
170907,adhs,1240,229575,185,89,96
48929,alexkill7,1244,230319,185,103,82
383692,ashinari,1132,209472,185,70,115
275534,bsmietana,1276,236192,185,102,83
595688,cdk8112g,1413,261587,185,129,56
621807,ctm8614g,1204,222847,185,92,93
198611,daythron,1246,230687,185,81,104
87829,dsn4441g,1242,229845,185,84,101
620631,gtn3747g,1411,261121,185,115,70
17220,hotspot,1072,198491,185,48,137
30629,hotwislak,1658,306843,185,100,85
92779,jabcok97,1298,240172,185,92,93
606032,kopterinio,1234,228325,185,87,98
70358,kosamelonik,1684,311625,185,109,76
421491,kpk1394g,1219,225555,185,79,106
187367,madzz,1349,249748,185,69,116
87722,marcin78214,1167,216046,185,69,116
121578,mlodziak0221,1170,216485,185,63,122
575644,mns8805g,1459,270037,185,126,59
586036,one2three,1652,305713,185,125,60
121948,pieselszalony,1135,210117,185,74,111
558150,rotakoworp,1282,237226,185,92,93
646554,sbf3032g,1484,274612,185,163,22
291414,sebek2010,1284,237644,185,141,44
359314,smn9498g,1270,235126,185,94,91
569723,szlachtawie,1335,247002,185,134,51
632819,tsd1477g,1355,250728,185,112,73
544936,umsiek,1403,259596,185,109,76
294546,urobiony,1707,315891,185,101,84
290523,whitegibson,1606,297202,185,102,83
1653,xyxpiotr,1369,253358,185,112,73
99577,zinedine,1884,348598,185,128,57
57260,3maj3maj,1206,222081,184,71,113
104448,adam1109,1185,218116,184,88,96
2594,aldona190681,1201,221126,184,96,88
586074,amstaf1,1719,316478,184,140,44
651962,aspideska,1472,270919,184,110,74
864,averies,1413,260081,184,142,42
111450,baumschule,1236,227503,184,87,97
248440,bnc6125g,1347,248019,184,128,56
572078,bsk8886g,1359,250195,184,108,76
40813,czacha666,1413,260051,184,109,75
261959,d4n13l,1659,305397,184,125,59
386166,dgp8550g,1294,238141,184,99,85
78722,duzyokaz,1534,282412,184,120,64
37538,elinett,1246,229345,184,117,67
320653,jabber,1478,272109,184,87,97
556046,janosikztatr1,1200,220853,184,91,93
222479,jrw,1247,229452,184,101,83
173596,kwadraty30,1411,259720,184,83,101
43155,lampioneq,1422,261824,184,110,74
91957,leser123,1181,217455,184,81,103
418,mateusz2097,1346,247807,184,164,20
239178,mrtrollek1,1647,303153,184,151,33
597846,muuunik,1165,214538,184,82,102
403539,mwk6906,1409,259316,184,104,80
54255,obrzek,1574,289638,184,119,65
356382,paranormalny,1267,233146,184,83,101
67868,patryk183,1234,227092,184,96,88
536526,pioteer,1280,235643,184,78,106
505332,sdd1798g,1464,269529,184,127,57
538771,sianek90,1165,214514,184,68,116
585995,stoleckupa,1335,245804,184,111,73
559331,sympans,1368,251837,184,127,57
47688,szmit11,1557,286602,184,102,82
204038,tacho11,1310,241206,184,92,92
67040,tester9,1504,276753,184,135,49
49061,turkusowypll,1108,203923,184,67,117
389865,vuxaxuv,960,176720,184,34,150
115201,wiedzma85,1352,248858,184,106,78
43234,zabcia15,1451,267054,184,96,88
83716,zaikan,1309,240862,184,98,86
195839,znekzlasu,1633,300500,184,110,74
10974,29vivien07,1252,229130,183,103,80
50189,90babelek,1360,248930,183,89,94
42201,addicted7,1235,226008,183,88,95
485095,arczi07,1248,228513,183,86,97
391,bartexb,1458,266835,183,119,64
52582,binarny,1280,234283,183,105,78
193496,dcn4587g,1349,246982,183,113,70
3935,deltazdelty,1219,223240,183,87,96
22653,ejserio,1317,241171,183,90,93
18738,fanlemo,1235,226121,183,82,101
580021,frelusia9118,1156,211702,183,73,110
484497,grzkal,1211,221677,183,79,104
70199,janekk1234,1278,233940,183,82,101
11461,jaszczan,1190,217781,183,96,87
70091,kambas09,1162,212828,183,70,113
404413,kkolejorz1922,1303,238576,183,109,74
104891,krzynardinio,1381,252738,183,125,58
52344,larys44556,1268,232141,183,94,89
68587,luisfabiano1,1287,235667,183,107,76
20037,lusi8888,1166,213548,183,95,88
223261,maglxi,1395,255376,183,107,76
208041,nblownaparte,1152,210906,183,58,125
59102,polkimn,1255,229842,183,99,84
570403,prze700,1485,271823,183,98,85
100310,przynajmniej,1435,262781,183,100,83
201899,pwk2173g,1383,253143,183,110,73
107995,sk0iceman,1444,264353,183,118,65
176044,snt7031,1177,215393,183,68,115
3452,stefan999,1415,259066,183,108,75
160159,tdg4875g,1200,219741,183,77,106
102880,varane,1896,347023,183,106,77
540465,wdw5087g,1388,254098,183,109,74
61969,wmp7256,1319,241541,183,92,91
593491,wwg492g,1521,278392,183,98,85
153474,10messi10,1312,238788,182,104,78
75741,adhs72,1232,224277,182,81,101
37539,adimo89,1150,209353,182,66,116
91353,azja2662,1249,227424,182,83,99
106000,bronekszogun,1307,237973,182,81,101
4740,chocolate12,1189,216572,182,81,101
2465,cleo125,1495,272126,182,131,51
578599,dtc1607,1167,212521,182,70,112
583330,fft3548g,1167,212445,182,78,104
317157,goorskaa,1326,241377,182,89,93
22399,huger,1318,239904,182,137,45
9810,ikadakimass,1224,222919,182,78,104
587558,joljol1,1444,262856,182,119,63
430306,ktc4766g,1390,253081,182,109,73
269049,luks580,1504,273838,182,104,78
39343,m3nczester,1479,269286,182,104,78
93778,mariuszw90,1139,207390,182,65,117
244603,maro,1274,232017,182,90,92
46988,mozaik84,1296,235887,182,92,90
19699,nipakaju,1087,197956,182,57,125
120136,noowwy,1475,268545,182,110,72
134558,pwk5695,1283,233547,182,105,77
603293,sfk4939g,1265,230391,182,89,93
392049,sgf6966g,1341,244141,182,119,63
238173,sgg1179g,1401,255052,182,127,55
84436,skarbiec25,1427,259767,182,106,76
564237,sliczna3,1258,229037,182,88,94
174383,stf7875g,1152,209832,182,68,114
452777,tms410g,1252,227927,182,114,68
55244,ugrywam,1679,305750,182,105,77
222576,winnerx8,1242,226155,182,114,68
365122,xkarolinkax,1478,269107,182,139,43
318901,zasadniczo,1304,237442,182,83,99
171611,ziela34,1269,231120,182,130,52
651363,zozolek133,1186,215932,182,73,109
88119,draaaaaven,1414,256023,181,134,47
533820,dregon,1591,288099,181,127,54
407233,esesman27,1438,260353,181,101,80
200486,forzajuve,1190,215417,181,80,101
80884,freezone,1256,227372,181,73,108
16890,fujarabe,1475,267139,181,134,47
583265,gff2929g,1151,208414,181,46,135
494185,godinhisheave,1293,234147,181,103,78
3122,kasia1317,1292,233944,181,97,84
647890,kramsonone,1541,279000,181,119,62
32590,limak8926,1235,223679,181,97,84
66962,lukassss22,1323,239521,181,107,74
272515,marcel2009,1600,289751,181,113,68
13909,mariochom,1108,200605,181,67,114
102825,ment0s,1527,276404,181,100,81
17300,mmww7366,1504,272293,181,114,67
43624,niuniek2a,1435,259870,181,121,60
475822,nmk6539g,1363,246867,181,110,71
567323,nwf6480g,1212,219426,181,78,103
80883,nyles,1334,241599,181,108,73
121911,oddamrower,1424,257819,181,111,70
113997,opole94,1279,231674,181,115,66
368106,paaaullla,1346,243698,181,135,46
248718,patyssska,1176,213007,181,85,96
1596,pelegrinho,1321,239160,181,72,109
133487,pinkdzida,1504,272333,181,92,89
422397,pkm4657g,1159,209806,181,75,106
428438,radoslavmagdy,1126,203914,181,69,112
83045,rosiexxx,1093,197959,181,51,130
602861,sfm4618g,1225,221900,181,102,79
549956,sikret,1313,237691,181,109,72
40121,staryormowiec,1303,235974,181,98,83
138293,tmp1851g,1331,240972,181,100,81
145681,uchatek,1622,293657,181,84,97
62515,umburak,1299,235146,181,107,74
223714,wdn1312g,1440,260707,181,102,79
106456,wikiprau,1181,213793,181,101,80
475902,wwm6230g,1336,241885,181,103,78
33291,11krystek11,1199,215823,180,74,106
8549,ac69dc,1433,258055,180,98,82
445651,andreana,1246,224317,180,54,126
179586,aneczkaa22,1285,231413,180,113,67
176476,borubar92,1267,228181,180,115,65
201843,borzyn,1348,242643,180,126,54
547286,bwk1632g,1127,203020,180,63,117
32572,ccb502,1160,208861,180,65,115
137905,d4ni0,1152,207483,180,59,121
244728,daf,1326,238802,180,88,92
109341,damian21abc,1119,201481,180,50,130
625804,dfk2686g,1261,227090,180,78,102
422328,endorfinaa,1410,253970,180,128,52
560574,gbc5083g,1867,336149,180,154,26
166251,iwona1981szel,1211,218064,180,94,86
401094,jagie1ski,1386,249595,180,94,86
3205,jaktaktonie,1448,260811,180,102,78
32465,kriszo123,1398,251742,180,111,69
153339,lama190,1190,214252,180,92,88
138001,mishka95,1168,210278,180,68,112
125049,moniaooo,1217,219089,180,101,79
311919,nakibluwpracy,1360,244897,180,100,80
560650,ntk9352g,1336,240548,180,100,80
312283,pgk1752g,1333,239950,180,107,73
228302,piootreek,1223,220175,180,101,79
352383,pmb187g,1192,214562,180,70,110
17330,r4c,1747,314482,180,116,64
136017,rafal333,1399,251854,180,107,73
78548,robert198,1533,276079,180,132,48
18362,sk0artissimo,1471,264931,180,113,67
136709,skaldak,1513,272424,180,80,100
312475,slavko553,1146,206372,180,58,122
44259,slawek35po,1039,187095,180,41,139
75796,stountscsrash,1503,270676,180,90,90
23163,su3zer0,1912,344311,180,64,116
18727,sztajmes,1284,231269,180,95,85
362775,tgw4180,1397,251572,180,103,77
14535,treningdarii,1679,302385,180,129,51
493588,uniatarnov,1436,258628,180,133,47
43807,urwecileb,1448,260772,180,133,47
97595,wojciech1993r,1328,239102,180,100,80
538956,xpetuniax,1206,217106,180,87,93
59317,youaremean,1242,223628,180,102,78
46286,zigi81,1242,223609,180,91,89
130432,0zabrze,1735,310598,179,140,39
536329,alfo,1630,291813,179,132,47
573906,bartek912,1574,281919,179,115,64
102495,barton667,1271,227640,179,73,106
488710,bnn1156,1356,242797,179,80,99
258543,btt7475g,1218,218181,179,101,78
398387,csf2545g,1155,206893,179,68,111
146266,dcw4690g,1332,238438,179,104,75
522519,dkw485g,1545,276562,179,125,54
209523,dpf251,1182,211647,179,81,98
144251,dwein,1271,227655,179,99,80
11640,frohiky,1465,262377,179,95,84
229676,kita10,1207,216211,179,99,80
92073,klaudek94,1068,191322,179,48,131
590707,kmn9204g,1264,226402,179,88,91
134754,kodi0607,1418,253898,179,103,76
124337,krzoslubianal,1257,225060,179,115,64
297469,ktp3633,1735,310714,179,132,47
564841,ladygm,1229,220138,179,80,99
72886,majkelosss,1183,211903,179,114,65
54092,masarnia,1294,231801,179,90,89
63968,mc11,1367,244775,179,130,49
116857,mendziorka,937,167846,179,18,161
9692,mich00,1364,244214,179,75,104
455428,mirkorze84,1208,216296,179,74,105
150766,mlody698,1157,207131,179,60,119
242693,ndg3476g,1393,249411,179,89,90
117768,nimfek123,1139,203893,179,72,107
124331,petrus2015,1310,234592,179,97,82
12218,poweradam,1443,258428,179,144,35
440941,ppm6554g,1401,250955,179,139,40
178400,przemoc84,1346,241037,179,117,62
20043,scorer,1692,302870,179,93,86
12924,stachpaluch,1353,242223,179,116,63
45003,tabor3t,1434,256720,179,96,83
322468,tom7366,1480,265056,179,120,59
372418,wellness,1248,223456,179,104,75
57290,xawi2007,1320,236437,179,87,92
621402,ziob,1204,215525,179,94,85
92364,93barcafans93,1438,256098,178,113,65
39935,adr3nalinkaa,1080,192329,178,63,115
106676,arturwilinski,1233,219610,178,88,90
131581,bartosz0707,1199,213555,178,91,87
69128,bms4262,1320,234984,178,120,58
538611,brzeg,1214,216189,178,83,95
508160,buhaha,1762,313661,178,122,56
111026,ciapek330,1179,209869,178,90,88
117105,domek324,1464,260659,178,113,65
138774,dthtb,1431,254750,178,99,79
1331,dumlee,1266,225380,178,81,97
415025,emeryt1234,954,169988,178,0,178
257180,eurobat,1531,272665,178,105,73
36013,eustachy30,1122,199813,178,53,125
408186,finbox,1464,260762,178,127,51
417817,gabe74,1419,252656,178,99,79
622517,grafite,1772,315504,178,141,37
359163,gramzpracy,1641,292252,178,106,72
436362,jestemcham,1523,271233,178,110,68
46706,kamilaxo,1583,281915,178,109,69
213180,kkw4130g,1335,237691,178,103,75
641297,marcinek99,1232,219446,178,77,101
113389,marek677,1237,220200,178,96,82
106271,marlborotuch,1375,244768,178,105,73
1621,mysticcribz,1482,263808,178,85,93
66150,myszahipcia,1154,205526,178,66,112
651608,ntb8136g,1375,244799,178,78,100
297315,ppele,1476,262889,178,107,71
361282,rahtol,1285,228768,178,106,72
278456,reliantbox08,1317,234581,178,118,60
106250,rybatczew,1266,225419,178,115,63
22014,saguarek,1385,246581,178,104,74
610714,sanji,1853,329843,178,147,31
458770,shallow,1209,215364,178,81,97
434332,stoch6,1530,272421,178,110,68
10317,thistype,1391,247616,178,111,67
214862,tpn8775g,1244,221474,178,103,75
260963,zonamariusza,1241,220902,178,94,84
618072,0ppa,1690,299279,177,98,79
41301,1k1k,1538,272401,177,106,71
435152,666og,1243,220063,177,112,65
42692,asia9696,1107,196114,177,68,109
116394,bart29,1287,227814,177,96,81
450099,bms9311g,1366,241956,177,115,62
65498,chamer,1209,214096,177,80,97
456269,ddd2400g,1530,270923,177,136,41
10150,derewiczniak,1340,237241,177,107,70
333509,dpp7916g,1347,238463,177,109,68
131503,dynkare,1531,271051,177,143,34
610706,fnd9101g,1221,216269,177,85,92
518684,gfs1248g,1725,305411,177,126,51
387437,heinzest,1236,218896,177,82,95
259517,hellyeaa,1165,206229,177,60,117
234819,jacrog,1326,234867,177,115,62
29803,kleemm,1240,219484,177,93,84
561942,knp6145g,1375,243388,177,81,96
33625,kozieka,1561,276351,177,105,72
9357,ladnemamoczka,1391,246283,177,96,81
562051,maintuna,1252,221736,177,88,89
808,matematykk,1810,320444,177,116,61
292471,matrixyz,1302,230456,177,82,95
47118,michalxxx100,1291,228535,177,92,85
541906,naitro,1430,253222,177,76,101
293074,niematakiej5,1879,332601,177,125,52
13191,nofiles,2024,358319,177,98,79
490375,piessynkota,1167,206694,177,85,92
3068,positiv11,1381,244453,177,96,81
276691,ptg7581,1288,228096,177,100,77
137662,ravenxd,1100,194726,177,54,123
113597,satch85,1241,219769,177,85,92
188818,sleepwithme,1732,306730,177,134,43
66670,speede1985,1289,228251,177,97,80
433918,staszeeek,1152,203984,177,73,104
41430,tidus,1637,289862,177,104,73
626838,tmn9798g,1258,222707,177,121,56
132351,wikuska98,1258,222717,177,98,79
484412,wwg4561g,1282,227057,177,112,65
435151,666ala,1149,202232,176,64,112
56220,a2s8,1300,228864,176,75,101
5692,adasko126,1384,243660,176,89,87
7135,adibayern92,1142,201041,176,59,117
20666,alexiaz,1187,208941,176,86,90
288645,anielicaa,1209,212820,176,91,85
74144,bammargera,1588,279637,176,90,86
570250,bfk4072g,1242,218706,176,72,104
114783,biurowiec,1966,346085,176,98,78
475414,bwp3188g,1329,234058,176,107,69
509405,cgun,1226,215906,176,81,95
10815,d3licje,1386,244083,176,75,101
41455,dawid3w,1248,219694,176,93,83
538370,donraba,1208,212731,176,94,82
25333,doplex,1268,223250,176,64,112
24936,flet92,1394,245385,176,106,70
36112,gosica81,1309,230429,176,99,77
94693,gracz312,1424,250764,176,87,89
73666,grehben,1469,258567,176,104,72
121073,gt540m,1544,271887,176,105,71
101730,kabar1245,1397,245933,176,100,76
536181,kalamburaarz,1317,231925,176,119,57
594292,kilpin,1442,253940,176,130,46
265663,leszek19d,1288,226817,176,98,78
2347,lop8,1188,209141,176,83,93
468141,mariobossman,1211,213285,176,99,77
240104,mff1235g,1286,226389,176,91,85
35004,mihou,1374,241956,176,104,72
57860,mnm7804,1209,212905,176,79,97
153016,momaleniedom,1623,285663,176,108,68
657746,nirszczyciel,1247,219513,176,79,97
54348,onnapalony,1171,206196,176,91,85
4836,pawe1978,1333,234705,176,96,80
565046,pinda11,1431,251951,176,125,51
622101,pnp7611,1131,199103,176,59,117
651468,pudlooo,1505,264941,176,98,78
9088,pustkapustki,1239,218090,176,79,97
197146,sewerynoss,1261,221950,176,86,90
54145,skorpiony12,1070,188464,176,40,136
155247,skorutoma,1542,271557,176,117,59
218685,srutututu1133,1327,233676,176,121,55
348275,stevensegall,1342,236260,176,100,76
109055,stoppl,1197,210826,176,68,108
649447,uotertek,1179,207510,176,90,86
289692,weily,1319,232219,176,116,60
311538,weresorry,1475,259775,176,87,89
623248,xsuicidex,1172,206446,176,60,116
109792,zolnierze,1769,311362,176,129,47
18164,zosik96,1329,233997,176,90,86
5800,15set1to9set,1445,252984,175,103,72
381603,aygorrek,1137,199045,175,81,94
419,boyx22,980,171655,175,17,158
26659,brutuska,1320,231005,175,98,77
497649,bumelek,1174,205565,175,81,94
264643,buulmaker,1400,245037,175,114,61
196496,bystramalutka,1401,245325,175,123,52
249511,cmb502g,1441,252273,175,87,88
385532,danio313,1235,216285,175,102,73
181863,discorelaks,1399,244914,175,78,97
3116,gmeracz,1155,202281,175,82,93
132477,graszzbotem2,965,168934,175,1,174
318477,hypocycloide,1350,236397,175,124,51
2386,jachu1910,1349,236082,175,99,76
61970,konrado7,1195,209172,175,73,102
22982,kreslik69,978,171279,175,25,150
117061,lucynecz4a,1173,205428,175,80,95
24145,maczeta3,1288,225430,175,105,70
84733,magdusia1,1402,245443,175,141,34
82366,mk216,1131,198044,175,53,122
360098,nkk1816g,1376,240853,175,100,75
185554,oskar33,1338,234292,175,92,83
303384,ponohwdp,1442,252455,175,94,81
268066,rafciu90,1439,251843,175,106,69
34894,razoooo,1972,345116,175,120,55
63101,renault2001,1410,246920,175,88,87
172675,rocky95x,1287,225338,175,97,78
126008,romper,1176,205919,175,69,106
104449,sebax44,1200,210092,175,91,84
225992,seweryn044,1152,201672,175,69,106
446230,sexxymama,1282,224358,175,79,96
243302,sexydiva,1585,277388,175,126,49
607595,sgc9030g,1190,208388,175,74,101
365403,sps3994g,1370,239920,175,113,62
29755,szogun2887,1272,222774,175,106,69
604445,vabank111,1310,229329,175,97,78
1498,willy1947,1327,232272,175,108,67
215399,wnorek22,1321,231197,175,112,63
350480,zagrajmyraz3m,1144,200200,175,69,106
133593,afrykadzika,1110,193189,174,59,115
9553,baronesgit,1239,215637,174,85,89
576270,cgk6280g,1266,220380,174,88,86
560791,dbn3782g,1305,227084,174,102,72
2079,derull,1313,228608,174,82,92
599662,dwg8918g,1341,233485,174,87,87
157377,emoboy,1644,286123,174,129,45
338620,gds2139g,1316,229084,174,98,76
76074,iitpii,1503,261560,174,108,66
3130,jjay8835,1274,221718,174,72,102
44538,kamsi1996,1302,226554,174,92,82
508805,kfs8219g,1397,243120,174,98,76
63860,likor,1229,213972,174,84,90
230457,lososj,1307,227504,174,117,57
67088,maciek0308,1255,218413,174,87,87
45420,malabella,1249,217458,174,109,65
61730,manaskal2010,1362,237071,174,119,55
52192,marek1973,1183,205886,174,72,102
241134,marmir7366,1472,256220,174,113,61
224899,mefiu1,1301,226416,174,97,77
323017,mixgame,1382,240593,174,70,104
340693,mnd4136g,1298,225975,174,82,92
575462,msb4358,1303,226847,174,89,85
570131,mtm2616g,1422,247468,174,114,60
260603,ogoras20,1415,246251,174,118,56
6325,on35alejka,1163,202467,174,72,102
245813,pablowpl,1214,211313,174,78,96
375808,piotrek202,1218,211953,174,72,102
404156,przemekk89,1352,235421,174,104,70
189541,pww3227g,1249,217448,174,94,80
75415,rewqasd,1538,267655,174,116,58
20535,rtc2021,1282,223089,174,92,82
277438,shalala,1504,261745,174,92,82
501517,snf1105g,1227,213643,174,71,103
491281,steven85,1329,231346,174,113,61
134770,sylvviaa,1212,210914,174,80,94
42896,tequiila,1092,190054,174,58,116
137943,tyvara,1258,218950,174,115,59
10612,ultimatumx,1399,243573,174,104,70
117595,vaporwave,1444,251291,174,134,40
235649,wsxwsxwsx222,1433,249476,174,78,96
279090,wtk5315g,1406,244684,174,110,64
425458,wwf657g,1274,221712,174,100,74
288430,wyrenderowana,1158,201525,174,72,102
610399,zederv2,1127,196199,174,58,116
17400,19stokus20,1236,213974,173,85,88
295292,1agnes9,1184,204958,173,78,95
13975,anetka3,1822,315212,173,78,95
159653,aniarumia1,1179,203995,173,92,81
259365,anicka1402,1250,216320,173,103,70
107549,bartekcyc,1458,252302,173,138,35
128506,bsi123,1268,219447,173,118,55
15784,cjs7637,1476,255396,173,97,76
80398,crazypants,1352,234057,173,100,73
493681,daniel1609,1283,222009,173,100,73
626977,daro1122,1247,215736,173,76,97
302838,domisiasty,1541,266750,173,126,47
32538,ewelinnn,1373,237682,173,132,41
611482,fbk9802g,1341,232048,173,102,71
516746,filip2808,1231,213076,173,87,86
514574,gdw9923g,1211,209559,173,90,83
50739,grubymalpa,1362,235725,173,81,92
379259,icoteraz92,1325,229394,173,77,96
26,itzjasper,1350,233691,173,89,84
40417,jaggust,1447,250427,173,97,76
38366,jeicam1,1214,210100,173,94,79
524902,joda,1314,227457,173,84,89
74635,kamisiamwo,1180,204165,173,83,90
591837,kierownikwchu,1204,208463,173,83,90
373030,knn2930g,1446,250165,173,119,54
72557,krystian335,1300,225068,173,112,61
17337,kuchcior,1371,237285,173,104,69
58583,kwb5742,1249,216193,173,101,72
464075,majki444,1263,218559,173,95,78
54693,marcode,1315,227661,173,103,70
110317,marmolenko,1436,248589,173,102,71
588016,mbb4261g,1128,195272,173,62,111
208619,msmr7366,1505,260475,173,107,66
1284,nemezis,1935,334808,173,106,67
132511,nieznajomaa14,1290,223180,173,90,83
454823,nkb7355g,1255,217221,173,90,83
186109,pakula201,1146,198388,173,69,104
93424,para99,1242,214986,173,79,94
75873,pawelolo100,1317,227900,173,68,105
458109,pfc2312g,1217,210618,173,79,94
256529,plac410,1503,260111,173,111,62
370477,poujufest,1412,244319,173,105,68
8543,qpeq,1644,284517,173,112,61
247656,sczagorze,1430,247411,173,89,84
295291,subone,1215,210242,173,95,78
242492,ths3,1135,196447,173,61,112
396511,uciekinierrka,1177,203743,173,87,86
109734,wmordejerzu,1625,281174,173,97,76
83764,zak,1505,260379,173,96,77
486882,1qwert,1370,235797,172,108,64
619564,abarthesseess,1197,205941,172,76,96
585792,aledym,1543,265467,172,98,74
94930,arturfc,1315,226268,172,99,73
133502,aster1931,1283,220692,172,90,82
182207,bezputos,1385,238348,172,99,73
83446,burichards,1221,210170,172,88,84
89027,chmielewiczko,1414,243340,172,116,56
7505,chudy1113,1294,222718,172,86,86
25609,czar2121,1224,210634,172,89,83
33376,deimonos,1218,209626,172,81,91
198439,dibas1337,1270,218455,172,106,66
2026,diglet222,1351,232446,172,99,73
385757,dmd8233g,1216,209227,172,83,89
347053,dnm6774g,1357,233497,172,93,79
256386,dss8652g,1419,244214,172,92,80
401860,frankyhb,1411,242811,172,90,82
359088,gcg9957g,1323,227669,172,100,72
154696,gct1108g,1261,217002,172,97,75
447433,gct1793,1213,208780,172,80,92
470674,gfk6218g,1049,180592,172,27,145
133068,hihuhuu,1550,266726,172,116,56
270053,hoakin,1214,208961,172,87,85
609210,hrabiamm,1371,235874,172,115,57
129768,huz4r,1082,186109,172,33,139
1885,kolesgit91,1336,229809,172,92,80
12361,kris1996,1364,234772,172,81,91
76240,laqq,1478,254329,172,82,90
20770,levusekx,1327,228359,172,87,85
97534,mapeka,1098,189009,172,42,130
11541,marchata,1363,234570,172,114,58
212308,mcf5955g,1361,234224,172,115,57
339436,mlecz2001,947,163018,172,2,170
415833,modessef1,1478,254231,172,85,87
2089,monikaa90,1412,242890,172,82,90
218809,ola1709,1325,228023,172,109,63
123428,oskareczek987,1249,214916,172,93,79
343451,oxana2011,1230,211608,172,56,116
34240,paleniezabija,1217,209362,172,96,76
532574,patryk2703,1471,253178,172,105,67
588436,perfectlyboy,1412,242874,172,89,83
24991,petroelaa,1286,221278,172,101,71
222944,pitr98,1262,217136,172,106,66
127272,przepalony,1432,246379,172,73,99
48279,rokitnik5,1425,245208,172,104,68
8353,shadowkyty,1635,281261,172,89,83
510760,silme,1122,193151,172,47,125
82914,sizofrenija,1130,194422,172,63,109
519187,sng1788g,1098,188892,172,61,111
1507,sssjpaw,1148,197615,172,59,113
93816,swc5248,1122,193015,172,43,129
61018,szyjatookon,1274,219256,172,122,50
367945,tompaluch888,1519,261410,172,105,67
11241,umbreon,1490,256289,172,103,69
330302,wiemcomam,1242,213685,172,85,87
311648,wnt3593g,1204,207102,172,72,100
630409,wtd4789,1167,200796,172,71,101
254036,x2501,1590,273580,172,111,61
199077,xkasiaaa,1263,217330,172,107,65
313323,znanablogerka,1284,220941,172,96,76
103315,zryjpasztet,1654,284646,172,117,55
7617,0174,1390,237748,171,84,87
102932,0303,1290,220637,171,81,90
259603,abc1234g,1610,275416,171,98,73
495284,autoelekytro,1234,211184,171,75,96
133562,balenziaga,1359,232468,171,94,77
173089,bloob18,1132,193650,171,69,102
82507,bombelek21,1143,195523,171,73,98
75412,chcechlopaka,1587,271516,171,106,65
171426,cnt2717g,1263,216116,171,81,90
639522,dmc960g,1386,237148,171,115,56
268332,edytag,1464,250417,171,83,88
29614,evemoree,1305,223325,171,99,72
15688,fbd4563,1317,225230,171,121,50
174450,felekjunior,1252,214188,171,87,84
18552,firanczdz,1332,227889,171,102,69
30596,fng6834,1174,200883,171,56,115
614812,foreverchild7,1207,206462,171,78,93
449368,jadezfestam,1406,240490,171,101,70
4151,juventino87,1347,230385,171,99,72
1906,kasjik21,1373,234948,171,62,109
294475,katariiina91,1184,202518,171,70,101
540795,kbmasterplan,1219,208557,171,78,93
574149,kcd1954g,1095,187359,171,60,111
132604,kiss0my0ass,1388,237371,171,87,84
400476,kmp8692g,1269,217043,171,94,77
475638,kpp4304g,1242,212405,171,101,70
633283,kwm4802g,1229,210326,171,95,76
28262,magi21,1232,210789,171,82,89
321022,malutki21,1203,205861,171,78,93
37074,marluka,1220,208781,171,96,75
202623,merlin9999,1342,229513,171,80,91
534682,nds8718g,1379,235885,171,110,61
165098,ndt3003g,1248,213571,171,102,69
111701,norberttorun,972,166270,171,59,112
81331,nowy329,1256,214787,171,69,102
44507,olimpja,1232,210749,171,91,80
13409,papryczka9,1359,232437,171,114,57
151677,pmb4025g,1364,233378,171,93,78
173058,rzeszow,1445,247131,171,100,71
294121,spuneryzm,1406,240488,171,92,79
1668,spyra,1337,228649,171,89,82
4477,szwarcenator,1353,231475,171,110,61
338312,tdf433g,1340,229297,171,107,64
419282,tipplerek,1266,216487,171,81,90
12495,travczynsky,1623,277535,171,110,61
127653,wwwwww2wwwwww,1557,266375,171,92,79
275321,zvidek,1318,225443,171,86,85
6866,1184,1480,251604,170,97,73
412755,4o4,1435,243994,170,90,80
151195,5lecie,1494,254044,170,118,52
340894,abillanako,1545,262716,170,123,47
6016,aniolemniejestem,1182,201076,170,61,109
1917,antyreven,1741,296131,170,99,71
68733,apokaliptos,1401,238176,170,96,74
469222,autoandre,1229,209048,170,81,89
1684,bania00,1453,247035,170,79,91
304784,barbakankrk,1378,234346,170,106,64
251509,bartosz2009,1198,203829,170,75,95
475670,bfm1142g,1333,226679,170,96,74
478800,blondassekk,1275,216821,170,86,84
35347,bolek122,1301,221333,170,116,54
58477,boyka25,1271,216232,170,91,79
560664,bsd7471g,1387,235891,170,108,62
407175,bws6694g,1380,234652,170,103,67
657206,cnd4786g,1165,198074,170,63,107
393841,ctc6171,1262,214624,170,70,100
282038,dambas,1364,231985,170,119,51
208050,fmf2471g,1324,225219,170,87,83
278827,fmw5136g,1380,234753,170,103,67
250133,geozone,1248,212217,170,74,96
512658,hacktx,1409,239649,170,88,82
293661,hazeezah93,1367,232476,170,86,84
66149,hohny11,1241,211047,170,106,64
65560,ipadtest,1404,238747,170,90,80
131287,iru29,1309,222600,170,98,72
101205,juriii21,1415,240587,170,112,58
4243,justaa11,1220,207555,170,90,80
586882,kcm9735g,1185,201485,170,64,106
467452,kingj23,1329,226045,170,101,69
42834,krzyssssiii18,1553,264073,170,120,50
17924,linuks,1729,294038,170,118,52
265161,majsterbb,1247,212127,170,72,98
551882,malto,1207,205298,170,90,80
74183,mama123645678,819,139374,170,19,151
230458,martijin,1054,179303,170,33,137
10704,maxhot,1311,222993,170,106,64
264189,michal868313,1175,199779,170,69,101
103902,mietusi,1319,224353,170,87,83
159446,mirek19910,1231,209314,170,76,94
650878,mpb6981g,1359,231061,170,95,75
201257,nbf7789g,1169,198794,170,78,92
54749,norwag89,1333,226721,170,76,94
297336,r3habkshmr,1724,293091,170,96,74
53357,rajdek138,925,157402,170,16,154
361900,rothrik,1204,204766,170,71,99
122916,rrbrtl,1537,261449,170,102,68
75265,siemanr1,1278,217269,170,94,76
117393,smyku262,1229,208981,170,78,92
343084,t3dy,1157,196744,170,63,107
452552,tdk392g,1392,236788,170,98,72
399,truskaweczka6,1213,206318,170,102,68
116828,una12,1384,235337,170,101,69
645133,vixevel,1510,256713,170,100,70
316222,wajjda90,1194,203040,170,76,94
54657,wera2015,1393,236869,170,73,97
326591,wgd9580g,1378,234379,170,118,52
402000,witold82,1193,202917,170,71,99
206430,wnw2715g,1556,264677,170,116,54
246755,woda007,1135,192978,170,64,106
251555,wpm1883g,1771,301071,170,131,39
106677,aaskab,1239,209502,169,84,85
397533,agonia,1603,271005,169,97,72
112087,anusiiia1,1073,181453,169,66,103
274883,bajac1991,1364,230652,169,83,86
5100,crouzer23,1482,250614,169,94,75
332198,csg903g,1490,251904,169,87,82
354927,ctb6888g,1736,293513,169,123,46
68064,czyzes94,1302,220183,169,81,88
101812,darrex753,1121,189488,169,3,166
213433,de1mon,1446,244449,169,104,65
142020,dnc6957g,1226,207207,169,86,83
647813,dns8488g,1772,299592,169,135,34
530760,donlis00,1262,213416,169,85,84
150928,donloocaso,1198,202618,169,66,103
171218,f1janis,1358,229538,169,100,69
438007,fioletowazaba,1114,188267,169,64,105
558848,greckh,1351,228420,169,124,45
49862,greko00,1302,220039,169,78,91
15875,lesing,1278,216127,169,82,87
524121,limesa,1210,204497,169,96,73
95709,macest,1265,213920,169,95,74
82088,mapa17,1240,209587,169,116,53
3197,mariuscovurlu,1240,209708,169,75,94
255034,mcptaq,1365,230767,169,98,71
248649,nala212,1371,231704,169,104,65
445435,ncm6331g,1403,237122,169,95,74
378310,ndm1166,1285,217196,169,83,86
13235,nervvag,1091,184448,169,63,106
589766,nwg2144g,1388,234641,169,108,61
49561,otiis,1471,248717,169,94,75
162109,pandii07,1186,200481,169,74,95
242669,pepik1975b,1164,196731,169,68,101
494015,perseusz,1322,223450,169,73,96
204082,psarus,1750,295764,169,104,65
114597,rankingowcowo,807,136390,169,1,168
528470,sisijulia,1323,223736,169,122,47
294194,sjg886,1065,180139,169,50,119
201059,soul123,1172,198150,169,61,108
44217,tkuba,1367,231032,169,85,84
91786,agnieszakk,1122,188600,168,56,112
22311,bless182,1185,199159,168,68,100
239839,bols10,1257,211301,168,92,76
475642,ccc3226g,1351,227046,168,112,56
133571,damian1171,1302,218759,168,84,84
123313,dawajlamo,1402,235550,168,103,65
193246,diido,1308,219856,168,103,65
586463,dmajdak,1237,207897,168,85,83
119600,faul4,1788,300420,168,125,43
432867,fbc4054g,1477,248165,168,108,60
282939,ffchch,1385,232703,168,79,89
207983,furnik,1267,212942,168,95,73
167651,gabi41,1202,202046,168,67,101
238975,gct8802,1260,211721,168,112,56
174999,gpt7796g,1250,210111,168,108,60
506235,halamadrid07,1264,212387,168,91,77
88818,hotfox,1157,194449,168,77,91
86818,hurelli123,1187,199573,168,80,88
199502,ivvvvan,1389,233447,168,81,87
23137,kasia2001k,1290,216799,168,123,45
9777,kowal0619,1377,231383,168,87,81
426661,krawczykkk1,1176,197708,168,67,101
418980,m4rko,1526,256522,168,93,75
202316,maselbas,1286,216145,168,87,81
269041,megipegi,1215,204201,168,93,75
431025,n0c0ty,1732,291112,168,106,62
408148,oo00oo00oo,1773,297917,168,88,80
184266,pierdzioch8,1185,199213,168,68,100
392019,psp3822g,1354,227619,168,86,82
16898,rewelka26,2089,351067,168,107,61
629902,roban,1232,207027,168,88,80
52441,shackhall,1416,237959,168,91,77
55117,skyfly2014,1497,251652,168,99,69
89017,spawarkack,1633,274458,168,116,52
535335,szewel29,1205,202561,168,108,60
249028,vexeoss,1350,226949,168,133,35
1255,vkarelka,1250,210092,168,74,94
79748,widzew0rts,1568,263425,168,81,87
262029,zmuszony,1208,203085,168,70,98
70797,zrytuz,1208,203067,168,65,103
89271,5t5t5t,1271,212301,167,80,87
83384,666alus,1331,222327,167,92,75
974,akkinom,1246,208139,167,79,88
501571,aleks4ndra,1474,246196,167,98,69
79812,azot0wy,1445,241366,167,89,78
76564,badrhari60min,1386,231587,167,105,62
25111,bialy8909,1231,205689,167,76,91
67873,chess3399,972,162439,167,26,141
69344,ci0tazciebie,1481,247416,167,89,78
5236,dampaw,1490,248963,167,71,96
568795,dejwidnolfak,1305,218040,167,91,76
170412,gentleeman,1530,255610,167,89,78
627897,gfp4322g,1252,209128,167,68,99
79698,hgr87,1188,198451,167,65,102
55763,igorcar,1071,179006,167,34,133
100083,innny,1594,266248,167,97,70
24127,jajucho1964,1480,247223,167,83,84
356716,kfc1846g,1319,220401,167,76,91
8363,kgg1355,1171,195638,167,59,108
250479,klaudyna96,1283,214345,167,91,76
108500,kubatekk,1227,205032,167,95,72
207391,mfw9218g,1449,242072,167,108,59
185790,mojeyhy,1389,232123,167,93,74
16684,morderca721,1061,177316,167,39,128
79943,nazywaszsie,1150,192072,167,95,72
446704,plotkowiak,1168,195177,167,68,99
129343,ryjec25,1718,286984,167,134,33
483946,sbc6989g,1339,223649,167,94,73
1022,strus55,1336,223276,167,87,80
284201,sumol,1143,190887,167,60,107
549475,szukamzony,1279,213748,167,80,87
55457,szymek16s,1327,221664,167,100,67
84870,takisobiedran,1588,265338,167,105,62
299268,telefonik,1454,242901,167,97,70
228660,teriannn,1289,215423,167,100,67
326766,tkc9521g,1458,243488,167,120,47
391546,tmk1984,1190,198853,167,69,98
234030,zuberekzrana,1301,217348,167,90,77
25428,13131313,1361,226024,166,89,77
336433,24agnes24,1353,224697,166,87,79
422623,aga568,1243,206375,166,74,92
420712,aha6,1253,208047,166,110,56
885,alizianna,1404,233127,166,76,90
43782,bartxe,1316,218537,166,78,88
104432,comamrasztam,1552,257771,166,94,72
556190,cwk5813g,1233,204721,166,90,76
116125,damianxx342,1227,203705,166,81,85
24010,danielekek,1144,189965,166,87,79
352748,danusiusia,1385,229992,166,88,78
491510,dsf2818g,1453,241207,166,124,42
16680,epmd,1383,229676,166,97,69
483357,fsb2333g,1182,196347,166,65,101
520940,gbg238g,1144,189934,166,69,97
438829,gwp486g,1327,220445,166,99,67
147111,herbaciarz3,1298,215551,166,96,70
262561,jaq1,1384,229826,166,85,81
576581,johnyglasgow,1247,207091,166,89,77
31034,kajamam,1305,216736,166,127,39
134979,kapitanzbik96,1225,203463,166,91,75
397588,karnaska33,1210,200937,166,69,97
12821,kaz01,1399,232234,166,75,91
572601,kgc9663g,1338,222206,166,94,72
62626,klaudix1,1249,207344,166,83,83
215745,komii,1711,284051,166,145,21
153547,ladnapanna666,1282,212873,166,70,96
373499,luishy,1181,196085,166,72,94
159191,majkel200,1212,201260,166,80,86
214433,malwina1988,1257,208797,166,84,82
142784,mameja435,1412,234462,166,80,86
353523,marcino901,1214,201545,166,70,96
405041,mgg9418g,1267,210452,166,78,88
316695,michu2112,1388,230443,166,116,50
15204,mikimiki123,990,164500,166,40,126
646967,multimultimix,1628,270412,166,107,59
5681,nafukanyi,1799,298764,166,100,66
475890,ndn5240g,1542,256051,166,97,69
215693,nmk4779g,1200,199275,166,79,87
325348,oralb1410,1211,201152,166,81,85
428668,p0dhale,1648,273683,166,73,93
6198,pauliskaa21,1449,240588,166,90,76
136626,pcb6141g,1279,212377,166,102,64
196143,pwc8933g,1247,207130,166,80,86
71863,roccorozpruwa,1472,244464,166,92,74
387471,smm9342g,1370,227437,166,103,63
466912,stiffler00,1193,198077,166,80,86
79093,szmalgurom,1653,274520,166,103,63
299599,tns5997g,1209,200708,166,69,97
254423,tomiii,1332,221248,166,102,64
102041,turniej1x,1526,253408,166,92,74
1510,veronicaaa91,1579,262120,166,89,77
155165,vrxxxx,1416,235118,166,88,78
106249,ziomalo,1146,190375,166,58,108
539273,5ikalafo,1701,280672,165,112,53
89952,agusiadarusia,1493,246444,165,80,85
470875,alc91,1123,185420,165,59,106
207467,arturrinhopl,1285,212106,165,122,43
349011,barcandol,1525,251699,165,118,47
344231,bestiacl,1867,308073,165,100,65
334699,celmerro1993,1253,206804,165,85,80
536534,cgd3174g,1331,219746,165,95,70
15004,countac,1345,222027,165,95,70
599642,cpp2786g,1076,177563,165,47,118
8621,damiank1987,1371,226260,165,100,65
28197,daniel11110,1334,220129,165,82,83
96082,ddddddd45,1262,208301,165,74,91
189259,diphergan94,1216,200767,165,83,82
71030,dmateuszb,1257,207547,165,63,102
409379,dpt522g,1181,195019,165,65,100
41990,dqwid,1276,210656,165,78,87
180388,efbn,1279,211162,165,78,87
657102,fsd8920g,1484,244972,165,120,45
434450,gcp1063g,1155,190651,165,62,103
461806,gfs4845,1356,223882,165,93,72
246432,ggb7281g,1343,221660,165,87,78
58724,hanys018,1372,226538,165,85,80
8677,hubcio86,1197,197650,165,63,102
207466,izasze,1114,183894,165,43,122
32674,jabbadabadu,1533,253052,165,101,64
5003,jaras1954,1392,229710,165,73,92
222060,johimbinaa,1498,247291,165,129,36
63292,kaczmar94,1391,229664,165,105,60
90509,kamtrak,1182,195186,165,71,94
24512,kazelot88,1331,219686,165,85,80
464136,kekekexd,1103,182109,165,43,122
6180,kicek222,1255,207087,165,73,92
638811,kkp3983g,1354,223554,165,73,92
9785,kociaczegg,1459,240888,165,99,66
530838,kpm9490,1317,217433,165,109,56
586543,kpp1843g,1442,238032,165,101,64
2014,lampus38,1406,232024,165,100,65
124535,marcopollo3,1538,253871,165,76,89
564731,massive666,1363,224998,165,73,92
175379,nairam1977,1322,218228,165,101,64
191901,panwujuniu,1285,212107,165,88,77
637631,paula378,1173,193705,165,67,98
340316,pogromcakadi,1300,214637,165,80,85
545480,sdf134g,1498,247323,165,123,42
68707,sexizosia,1462,241318,165,129,36
192691,spd5824g,1187,195868,165,61,104
602971,tabc,1482,244657,165,104,61
324966,tcc3081g,1250,206314,165,74,91
525380,tdw3834g,1269,209386,165,82,83
230937,trawka777,1501,247803,165,149,16
94537,truskawka219,1327,219095,165,97,68
266867,universal720,1318,217539,165,127,38
80601,xarcusx,1251,206528,165,77,88
384729,0051,1537,252171,164,90,74
103455,99euro,1523,249879,164,89,75
27319,9xxx,1358,222799,164,105,59
94158,aquaxd,1282,210366,164,95,69
906,aro0987,1309,214807,164,98,66
204286,asq1106,1093,179282,164,44,120
574687,bakuwiku,1140,187059,164,60,104
449,bojan84,1413,231767,164,117,47
82247,burnquist,1411,231547,164,85,79
391459,chytryplann,1339,219602,164,81,83
606245,cmb9735g,1300,213359,164,98,66
465730,cwk6899g,1351,221594,164,88,76
140723,cyrknakiju,1382,226759,164,92,72
31819,dfsdfsdfsdfsd,1381,226580,164,63,101
46229,dntcarewntcar,1407,230831,164,96,68
415713,dzulita,1182,193929,164,73,91
75504,estera1207,1365,223985,164,99,65
151092,falastra123,1050,172218,164,60,104
539665,fcn1811g,1283,210558,164,83,81
522555,fnd4551g,1320,216527,164,102,62
616753,gardevoir,1235,202603,164,78,86
127404,kanagawa,1316,215933,164,72,92
288569,kinia9449,1270,208339,164,102,62
199126,kkf6293,1184,194297,164,64,100
25176,kkicia9,1206,197865,164,64,100
634747,kochamjakuba0,1146,188039,164,75,89
610440,kwaczetory,1244,204174,164,109,55
14209,marcinagatka,1168,191672,164,60,104
277140,mlod1x,2250,369004,164,105,59
475640,mts9079g,1251,205277,164,88,76
172614,nabijacz0050,1750,287106,164,120,44
468140,norbi90,1166,191367,164,70,94
7824,paxii1,1321,216785,164,103,61
213472,pilkarz73,1354,222188,164,107,57
15893,piotrex240i,1310,214957,164,79,85
239609,pogromcalipki,1157,189822,164,68,96
19023,roman745,1209,198397,164,82,82
509404,sasiadcygana,1328,217917,164,105,59
372582,sebbypl,1329,218032,164,124,40
178401,shatfie3,1113,182638,164,54,110
519178,sisikol,1197,196431,164,73,91
3233,song0ku,1568,257164,164,82,82
543630,tkn399g,1352,221869,164,97,67
51551,tomasz0100,1205,197749,164,79,85
24073,tomekb888,1073,176095,164,40,124
101903,viola04,1126,184750,164,54,110
475572,wcg4134g,1469,240989,164,81,83
352729,wgm9535g,1519,249121,164,79,85
44353,wkupiesila,1504,246809,164,112,52
222543,wps562g,1358,222868,164,96,68
654122,xezario,1250,205125,164,84,80
643395,yogo25,1163,190732,164,78,86
172477,420xblazexit,1157,188728,163,70,93
581168,cbc1752g,1509,246049,163,108,55
10208,clipper91,1565,255240,163,96,67
253590,cwb868g,1163,189572,163,56,107
437009,dcw6224g,1393,227078,163,94,69
10023,desider4ta,1870,304872,163,97,66
237931,dgf4750g,1178,192078,163,67,96
364115,domi9876,1106,180312,163,50,113
71087,ewaaa1430,1178,192163,163,83,80
449955,freeelancer,1401,228519,163,98,65
31487,gracjanaf,1123,183116,163,57,106
3761,gregxx27,1415,230664,163,103,60
420711,grzeskyy,1132,184599,163,53,110
457626,jakuzs,1257,204969,163,82,81
410308,jeszczeciasna,1307,213106,163,79,84
226639,john812,1187,193589,163,67,96
222037,kalafior88,1450,236357,163,110,53
458869,kameehousee,1388,226259,163,81,82
195807,kkb5689,1246,203228,163,81,82
291310,kmd7751g,1377,224550,163,87,76
475120,ko123ok,1377,224537,163,125,38
135968,lola201,1218,198557,163,71,92
91694,maldini06,1257,205001,163,80,83
45084,margolak,1246,203157,163,94,69
147235,mecenasio,1337,217945,163,119,44
172788,mewenement,1209,197217,163,104,59
101699,michalol28,1425,232292,163,102,61
24092,mishamansor,1516,247116,163,96,67
203330,mte,1289,210256,163,86,77
89555,perezz2,1280,208681,163,86,77
6269,philtz,1470,239707,163,82,81
340976,pmc3318g,1363,222283,163,99,64
132274,pok0nany,1805,294252,163,65,98
84416,pokiero,1134,184866,163,53,110
80735,princess2,1187,193492,163,83,80
398773,radex1802,1167,190291,163,59,104
155659,rygiel96,1223,199511,163,80,83
276077,shrek5891,1291,210584,163,89,74
14639,sixtense,1270,207051,163,85,78
165046,skoczek691,1307,213159,163,105,58
230343,smincia,1225,199792,163,99,64
339080,szalonazabka,1266,206470,163,90,73
295601,szukamzoony,1354,220836,163,83,80
395403,szwejlbn,1277,208174,163,70,93
8565,warchol007,1360,221694,163,111,52
254810,wbs118g,1200,195630,163,78,85
144393,wct4095g,1436,234220,163,76,87
93178,xkzkx,1207,196801,163,71,92
144150,yourbigsin,1577,257117,163,86,77
204330,11kaczor,1372,222288,162,86,76
141168,24oo,2278,369171,162,96,66
80196,2pac2,1427,231233,162,100,62
551459,adrian105,1434,232418,162,82,80
19744,alex0076,1254,203171,162,76,86
202072,brzeziw,1303,211100,162,108,54
339352,cwb6341g,1252,202973,162,68,94
403570,czar09,1648,266983,162,87,75
200149,czyzu1979,1347,218309,162,94,68
146307,dasiu89,1293,209485,162,90,72
110980,delikatne,1462,236909,162,93,69
22749,dmaja,1365,221228,162,105,57
568972,dsn8276g,1216,197153,162,72,90
416,egon128,1293,209550,162,91,71
97526,gehrich,1571,254594,162,87,75
448356,gregory,1420,230092,162,95,67
263006,hipekus,1184,191811,162,54,108
98697,iamasonofgod,1387,224741,162,95,67
407200,jaca0010,1514,245390,162,110,52
612349,kaczuszka1231,1381,223767,162,84,78
68501,karol0092,1422,230468,162,87,75
311420,kcd6355g,1211,196234,162,72,90
40648,mada2611,1290,209100,162,74,88
153050,matiooooo,1315,213121,162,115,47
201844,mekashika,1263,204683,162,77,85
645859,mflor,1505,243839,162,108,54
21801,namitoleszcz,2180,353177,162,122,40
556968,nathalies,1277,207009,162,67,95
40636,nika3110,1284,208169,162,95,67
468739,niriena,1122,181919,162,65,97
233,nugatek12,1258,203909,162,82,80
134370,ollabogarety,1336,216501,162,86,76
394040,panizbroda,1523,246847,162,90,72
63009,pawelkwlk,1237,200479,162,64,98
475698,pcn5134g,1396,226158,162,107,55
571536,przegrane,1512,245080,162,122,40
44111,sieeeeema,1582,256301,162,106,56
139703,szafranowy,1161,188111,162,79,83
8655,torpedox,1465,237352,162,89,73
4671,trafic77,1449,234821,162,70,92
302811,tylk01minutak,1317,213488,162,76,86
1785,x2x,1550,251178,162,87,75
186692,xmelczix,1184,191958,162,80,82
278621,xxdaro,1129,182966,162,52,110
9856,zkzjaro,1326,214871,162,96,66
298218,zorro134,1172,189956,162,77,85
213983,666tymoteuss,1244,200327,161,96,65
409377,adamsz1,1254,202043,161,94,67
90278,arseeeeee,1208,194615,161,63,98
266427,bialychinczy2,1240,199650,161,76,85
563885,bnp8319g,1317,212137,161,92,69
77709,btw2485,1155,186006,161,54,107
44475,bvbartek,1247,200900,161,81,80
68947,carski,2018,324911,161,93,68
13386,cdf8338,1150,185194,161,61,100
367561,cgc1984g,1407,226623,161,100,61
3059,cinnekk,1152,185571,161,74,87
76865,ctp8534,1206,194190,161,76,85
7102,damianjezol2,1350,217477,161,72,89
116338,ddziadek1109,1367,220146,161,82,79
95008,derdus,1241,199802,161,68,93
539983,dfn2201g,1212,195133,161,72,89
462612,gfm9834g,1344,216415,161,95,66
345956,ggb1740g,1420,228666,161,68,93
393634,kdebovsky,1268,204263,161,95,66
153888,kezcyre,1210,194914,161,95,66
155320,konopmistrz,1195,192479,161,61,100
153573,krzysolaboga,1327,213673,161,70,91
93224,ksieznaaaa,1134,182691,161,53,108
387769,lofka123,1282,206447,161,93,68
167827,m00niczka,1297,208906,161,81,80
131208,madz97,1201,193509,161,85,76
5576,makakaga,1342,216190,161,89,72
204611,margo66,1449,233428,161,103,58
2945,mateuszozog18,1356,218333,161,104,57
494740,monnnnia,1210,194892,161,91,70
14904,mwc7159,1215,195773,161,81,80
8281,nataliax13,1315,211729,161,91,70
682,natkkkka,1397,225048,161,94,67
369200,nmp2431g,1344,216445,161,96,65
532168,nnw1482g,1096,176541,161,49,112
77688,ohdariusz,1171,188580,161,97,64
173420,opsiocha,1362,219282,161,102,59
191998,patryk555,1195,192455,161,107,54
55118,pelenkontrol,1524,245444,161,89,72
122626,pinnacle,1331,214368,161,109,52
20364,pusia94,1270,204575,161,91,70
133994,robotreningow,1392,224145,161,79,82
5008,sam456,1338,215575,161,87,74
382968,sara1997,1500,241644,161,102,59
178207,smm9531g,1349,217286,161,94,67
296991,thc93,1352,217792,161,91,70
86308,tomek2312,1118,180018,161,40,121
34562,uniorpl,1407,226662,161,100,61
110592,wspaniala91,1324,213248,161,85,76
130934,wypiic,1657,266923,161,63,98
49280,zagramy20,1574,253468,161,82,79
41496,zb44,1373,221127,161,96,65
562668,7series,1380,220927,160,82,78
446547,awesomehunter,1279,204775,160,109,51
5622,bartekgruszko,1453,232527,160,73,87
540646,basinski,1374,219952,160,83,77
606983,beda1980,1212,193943,160,71,89
476489,bwc671g,1239,198325,160,85,75
85675,cantalejo,1505,240894,160,82,78
280426,cgb7696g,1278,204523,160,81,79
292495,cmp9725g,1336,213913,160,93,67
921,dida324,1281,204994,160,69,91
134864,elza9,1321,211372,160,81,79
301394,fmw3749g,1558,249331,160,96,64
15602,fuller9,1485,237735,160,85,75
132991,gegos21,1286,205797,160,68,92
602462,glogow,1718,274928,160,113,47
310284,gwn5669g,1290,206450,160,101,59
3234,howd0youdo,2097,335592,160,92,68
37142,hp87,1412,225949,160,51,109
132710,inka8431,1298,207734,160,82,78
42217,intelcs,1449,231946,160,91,69
252021,iphone6pk,1358,217283,160,97,63
76821,jabadadu,1484,237479,160,86,74
55083,kasperski,1250,200082,160,74,86
31921,konstiii,1165,186556,160,76,84
152382,ktototak,1650,264014,160,68,92
120333,kurnikturniej,1686,269893,160,117,43
497929,lksmistrz,1204,192698,160,72,88
51620,lpu92,1207,193175,160,79,81
400575,lukaszoju,1139,182342,160,59,101
438498,mala000,1230,196934,160,79,81
45567,malgoskaaaaa,1102,176377,160,54,106
5345,maminteres,1216,194561,160,81,79
112536,mar7878,1316,210648,160,96,64
84884,mati8888,1335,213756,160,106,54
397153,mgk8672g,1163,186126,160,51,109
389918,mofades,1143,182994,160,57,103
644544,mtc7655g,1008,161433,160,35,125
250981,npm5505,967,154872,160,23,137
637285,ntp552,1280,204893,160,112,48
234946,savege,1393,222883,160,80,80
452952,sdp5342g,1209,193444,160,75,85
495449,siaraa177,1181,189056,160,65,95
469168,siedzewpralce,1404,224756,160,109,51
70485,skeuomorphqio,1568,250980,160,83,77
161987,stf5694,1232,197122,160,67,93
11418,stulipilka,1292,206841,160,83,77
181571,sukurukukum,1654,264703,160,97,63
28771,wiola3666,1331,213096,160,123,37
27819,1887hsv,1328,211276,159,104,55
65767,19swiergi91,1202,191247,159,58,101
117638,5058,1686,268179,159,97,62
455199,angelam3rkel,1686,268190,159,70,89
17970,aniia94,1317,209466,159,90,69
344569,aryan,1274,202662,159,87,72
1174,chamstercova,1259,200322,159,90,69
4739,chycopodloge2,1229,195442,159,87,72
26248,dadakud,1179,187514,159,76,83
177228,davinio177,1528,242974,159,70,89
367895,dmw1476g,1330,211574,159,64,95
108483,fasolka13,1182,187960,159,61,98
310315,fgm158g,1373,218332,159,111,48
438072,fsg7452g,1220,194058,159,67,92
167051,gpc5856g,1348,214369,159,84,75
166155,gww9752g,1218,193734,159,77,82
241258,hejmadzia,1462,232594,159,90,69
78886,iwgo,1260,200439,159,99,60
193464,jagoda17,1520,241828,159,150,9
89587,jerry32,1230,195676,159,79,80
657930,kck8847g,1395,221816,159,86,73
49733,kgb3regi,1833,291501,159,77,82
157217,kicior97,1316,209391,159,91,68
463698,kitre,1328,211184,159,93,66
2314,kostrykos,1375,218671,159,88,71
414456,lamencjo,1272,202381,159,69,90
6367,lolgupafka,1374,218581,159,74,85
468227,longer2382,1197,190465,159,98,61
72928,marcindomian,1126,179088,159,60,99
219453,mat3us2,1436,228432,159,113,46
348210,matrixgamespl,1233,196202,159,92,67
473716,maul,1391,221240,159,106,53
185512,mhd1,1350,214650,159,85,74
385255,noisisi,1139,181104,159,69,90
7469,patryktmc92,1097,174575,159,39,120
478290,ppf6945g,1010,160636,159,0,159
84754,qwerty69pl,1209,192354,159,74,85
23897,relukt,1741,276854,159,112,47
4259,robik11,1259,200317,159,69,90
243052,robinhobrazil,1295,205973,159,77,82
118062,rodziak1,1115,177413,159,45,114
560656,saintkosa,1492,237339,159,103,56
159871,shadow012,1430,227380,159,106,53
589935,snk9458g,1478,235114,159,117,42
451819,spadajdajdaj,1190,189252,159,62,97
6702,szymcio24,1262,200797,159,79,80
29574,tata00,1426,226852,159,87,72
297749,tomek342,1312,208643,159,88,71
150760,vvs,832,132379,159,17,142
528246,wgg1938g,1447,230174,159,98,61
158115,wicher234,1423,226357,159,104,55
182988,wodziak5,1345,213929,159,86,73
258943,zimnydran2315,1275,202796,159,105,54
235712,ziolek190,1345,213923,159,113,46
176296,zoltan1010,1139,181156,159,63,96
569319,0buu0,1228,194171,158,86,72
17938,anatolosw,1305,206331,158,77,81
140490,bboybaku,1103,174356,158,56,102
350627,bsp2677g,1212,191639,158,73,85
488159,calciatore2,1422,224733,158,84,74
649392,chuwdu,1460,230825,158,74,84
383594,ckt8979g,1545,244233,158,117,41
569699,cozaogier,1614,255033,158,108,50
132760,cristiano234,1373,217071,158,89,69
50703,czyjtopies,1720,271910,158,114,44
97272,darko3693,1238,195760,158,70,88
255280,dzikiwonsz18,1423,224933,158,92,66
111537,elcia04,1240,196033,158,81,77
5852,ggnatex,1153,182216,158,51,107
83390,gutek698,1305,206331,158,98,60
146952,halkaxx,1300,205439,158,106,52
249200,ineedyoou,1855,293167,158,142,16
263103,jedrula23,1249,197344,158,91,67
175761,kaprawy,1366,215890,158,84,74
13328,kobbea,1098,173573,158,45,113
529992,krychu1910,1192,188342,158,72,86
85040,kukaz,1341,211930,158,99,59
221700,miko0303,1435,226859,158,127,31
67540,mincegirl,1264,199716,158,90,68
292060,mm1073,1465,231593,158,103,55
61093,mszosti88,1162,183752,158,55,103
220106,nbg4325g,1108,175198,158,47,111
327907,o1991,1429,225790,158,81,77
96918,oglooc,1135,179475,158,57,101
441017,onthefloor,1557,246154,158,82,76
559036,panas862,1274,201356,158,74,84
103410,partijos,1558,246283,158,110,48
298679,pcd4303g,1353,213804,158,87,71
488367,pdk8379g,1200,189702,158,74,84
385363,pkf6262g,1144,180796,158,48,110
78151,popykam,1213,191729,158,49,109
328689,psk4635,1134,179209,158,60,98
262507,psw1135g,1251,197758,158,81,77
602688,pww9516g,1514,239354,158,103,55
21023,shakalakamake,1280,202329,158,96,62
466065,siii,1641,259332,158,90,68
107051,skor1566,1484,234598,158,107,51
406597,slaskee,1260,199203,158,84,74
21360,slodekrlz,1726,272741,158,115,43
120453,solodragon,1202,190070,158,74,84
281150,szzs,1429,225836,158,100,58
338300,tgk5056g,1505,237845,158,88,70
310791,thebeast1,1472,232667,158,93,65
222201,thew1,1262,199457,158,88,70
95399,tomi06sz,1136,179559,158,65,93
97169,wewe1234,1219,192668,158,64,94
39173,wiosna0101,1533,242244,158,101,57
407622,wjsn,1392,219963,158,72,86
73421,wladcaasmieci,1872,295895,158,105,53
13046,ziomalek90009,1309,206967,158,83,75
630380,01aaa,1431,224808,157,107,50
321615,0matko,1602,251637,157,101,56
53818,14stefan14,1192,187184,157,62,95
165088,8991,1415,222238,157,80,77
405609,bardzosamotna,1368,214897,157,91,66
443805,cdw7492g,1123,176319,157,45,112
434109,cff3604g,1385,217467,157,86,71
1376,davvidoff,1279,200866,157,99,58
643898,dawol2006,1329,208698,157,110,47
590296,daytonus,1208,189717,157,68,89
514626,dbw6829g,1139,178826,157,68,89
304205,ddamiann10,1376,216042,157,107,50
83681,dodokubiak,1193,187324,157,73,84
39811,dziobek1996,1204,189108,157,77,80
580713,fdd6133g,1100,172755,157,52,105
39084,gubbernator,1335,209739,157,87,70
55354,gutaflep,1550,243413,157,102,55
1394,herbi69,1326,208249,157,79,78
140282,husarnia,1651,259247,157,83,74
170307,izkaulka,1359,213429,157,84,73
635396,kalinowskim,1167,183233,157,68,89
60615,kapi7311,1138,178675,157,63,94
75250,karol3815,1376,216042,157,89,68
20070,karolciu93,1319,207123,157,118,39
93571,kkc1,1606,252232,157,114,43
398287,ksiaoksiej,1163,182644,157,65,92
602862,ktc3793g,1176,184668,157,68,89
97985,kugi,1188,186667,157,67,90
218813,kvictorius,1409,221251,157,88,69
504239,landrynka1,1077,169098,157,38,119
276908,leszcz123,1486,233314,157,105,52
340748,mag012,1118,175667,157,55,102
87455,magmar40,1198,188190,157,68,89
4410,mariusz35z,1171,183867,157,52,105
627892,mbw1911g,1326,208332,157,90,67
486200,mkw872g,1347,211513,157,87,70
96849,monia1916,1221,191793,157,74,83
256517,natelefonie,1332,209256,157,99,58
132925,nauszciemnie,1641,257776,157,106,51
12166,nika2310,1389,218108,157,106,51
2588,nowosc,1389,218135,157,85,72
245791,pbm7385g,1264,198546,157,80,77
45275,petlusia,1264,198540,157,83,74
123646,piocio555,1104,173461,157,47,110
464479,porucznikg,1792,281496,157,110,47
417152,przytulanka6,1200,188524,157,67,90
187413,radek007,1079,169472,157,42,115
484740,rupertintelig,1742,273596,157,113,44
217851,sadowa1,1586,249038,157,96,61
120749,sally1,1056,165936,157,38,119
11643,seciak,1649,258995,157,106,51
394865,sfk2174g,1184,185993,157,61,96
29665,skrromny18,1990,312571,157,87,70
3327,stupszczak,1314,206409,157,84,73
221295,tylkosterydy,1291,202761,157,98,59
7329,user13,1494,234713,157,83,74
26247,weraw123,1213,190447,157,81,76
593268,wizzurd,1645,258336,157,106,51
117116,yayamiomate,1415,222266,157,87,70
14702,123padnieszty,1415,220748,156,115,41
1589,antyslask,1368,213538,156,73,83
349456,badb0y,1613,251699,156,103,53
614544,bbs6473g,1118,174431,156,39,117
256982,bialyst0k,1708,266544,156,86,70
223193,caviar86,1259,196457,156,84,72
9454,cegielka88,1314,205014,156,85,71
271814,cieniasjestem,1721,268606,156,105,51
84469,cienszkarzyc,1428,222872,156,87,69
15453,coach44,1469,229244,156,139,17
137551,csg6123,1270,198121,156,70,86
627399,csk3792g,1144,178498,156,59,97
72007,damiandesan,1102,171991,156,35,121
392769,delecta,1087,169606,156,47,109
663648,dmg2989g,1377,214950,156,86,70
227959,emilek84,1330,207484,156,94,62
69515,geralddd,1437,224265,156,83,73
371766,gnc5320g,991,154684,156,11,145
240218,jakubsob,1265,197475,156,108,48
271332,kkw2587g,1103,172084,156,25,131
370041,kms1580g,1551,241991,156,123,33
228569,kumikosc2,1275,198986,156,91,65
9177,lachonix,1486,231919,156,88,68
481896,legia08642,1059,165272,156,31,125
193822,madziulka96,1180,184209,156,77,79
3499,mametka,1291,201505,156,80,76
38167,marze73,1520,237272,156,95,61
424269,matiii0122,1269,197995,156,80,76
121927,myszka15883,1248,194732,156,82,74
513618,paod,1664,259620,156,106,50
133321,patisx33,1109,173102,156,47,109
275,pawo90,1420,221585,156,92,64
48107,playerpwd,1376,214779,156,91,65
287554,pmd4464g,1357,211800,156,97,59
574228,przedszkolacz,1353,211072,156,121,35
1398,sfinks85,1421,221746,156,124,32
133320,ssnajperr,1290,201298,156,109,47
120929,stivvv,1304,203511,156,109,47
638104,touchpadplay,1435,223912,156,83,73
101658,wampirowski,1257,196103,156,74,82
14321,wirnik123,1235,192714,156,50,106
21986,wlewy13,1264,197199,156,93,63
90782,wypadek2013,1034,161317,156,6,150
282898,agnieszkanh17,1143,177257,155,48,107
323431,ankadodymanka,1475,228730,155,111,44
285853,artblastwwa,1531,237351,155,93,62
5314,beatapolice,1243,192697,155,85,70
1243,berni0869,1297,201130,155,87,68
411582,bos0,1710,265167,155,100,55
269694,buster97,1228,190346,155,74,81
48005,cham,1632,253003,155,100,55
420257,choj08,1285,199226,155,105,50
91026,chylin,1218,188810,155,86,69
40018,cieniasek1,1124,174294,155,45,110
91025,davis1991,1181,183190,155,69,86
398,demptd,1154,179021,155,63,92
258542,dnd4607g,1162,180221,155,65,90
245692,dsw5253,1189,184357,155,63,92
304527,ekakub,1156,179249,155,55,100
396891,ewelina9005,1412,218973,155,76,79
240219,filmik11,1126,174536,155,47,108
163968,fkk947g,1253,194359,155,60,95
149675,indianchief,1398,216824,155,77,78
3172,itkcierozwale,1440,223320,155,94,61
447116,jetemlepsza,1455,225667,155,97,58
459303,kgb8540g,1338,207426,155,93,62
228407,kony4,1292,200325,155,89,66
335034,krullu,1213,188143,155,73,82
286027,lalo1234,1061,164552,155,35,120
209116,m100jan,1377,213494,155,71,84
6876,marianna15,1725,267487,155,66,89
518677,matisssxd,1309,202964,155,118,37
391661,mcb3200,1304,202216,155,90,65
647571,mnf426g,1207,187164,155,76,79
471288,ojejejee,1523,236157,155,91,64
9540,ok2,1848,286501,155,83,72
423076,oliszek,1185,183748,155,58,97
138480,onczarymary,1408,218351,155,104,51
91198,pawelm1988,1204,186739,155,65,90
597206,pellee,1289,199799,155,85,70
245582,pprzemek,1264,195995,155,94,61
604370,redi215,1360,210807,155,86,69
638758,sennyjestem,1467,227459,155,117,38
186572,serekwiejski,1058,164072,155,27,128
137353,siala5,1437,222748,155,81,74
22595,sirpsycho92,1266,196244,155,66,89
95000,srolik7,1277,197942,155,62,93
571414,stc9569,1443,223772,155,103,52
4810,syn12ki,1333,206688,155,83,72
96612,takitam11,1177,182501,155,60,95
622042,tcs3937g,1121,173803,155,48,107
236607,tdg3111g,1501,232661,155,73,82
155629,thetan85,1267,196501,155,71,84
180377,tkg1390g,1262,195624,155,76,79
201498,ts1979,1210,187557,155,61,94
135418,tygrysek2009,1242,192606,155,59,96
274461,wrednykot,1508,233842,155,70,85
249389,xbl0ndyna,1620,251185,155,132,23
585285,87heppymil,1088,167554,154,46,108
5082,abigor07,1357,209030,154,79,75
333679,adek23,1250,192523,154,102,52
536127,aniachetna,1235,190272,154,55,99
460191,atakkomara,1461,225022,154,94,60
142836,bfc1015,1122,172929,154,42,112
130821,bzykoll11,1188,183012,154,65,89
385531,cdf5402g,1190,183288,154,68,86
109127,chris0000,1279,197063,154,70,84
140029,d12eminem,1713,263826,154,100,54
105806,damianjaga,1192,183622,154,56,98
418606,dhs4444,1450,223312,154,80,74
132548,dudaisieuda,1475,227164,154,114,40
547055,fdk3525g,1333,205361,154,88,66
403966,holkas,1760,271051,154,113,41
2358,hotpatka,1314,202361,154,91,63
132268,jacky3,1457,224526,154,85,69
126527,juralisk,1233,189898,154,74,80
15005,k8805,1344,207071,154,107,47
268532,kajtek1989,1280,197145,154,88,66
244476,kameleontzw,1174,180846,154,74,80
129439,kamilciaqq,1257,193722,154,91,63
531327,kartydogry,1316,202722,154,85,69
114681,kwadrat030,1459,224731,154,78,76
73509,lebigmac94,1288,198373,154,76,78
400509,ligagolee,1288,198495,154,76,78
99246,lokas1,1185,182582,154,69,85
17320,lukki1988,1126,173505,154,50,104
284030,m1strzu77,1301,200424,154,100,54
422473,malazolza,1183,182220,154,50,104
187159,malinowa1804,1332,205131,154,117,37
125993,marius987,1321,203466,154,88,66
245716,mtf2392g,1342,206764,154,78,76
267848,oddamcisiee,1320,203295,154,88,66
742,p1963,1208,186044,154,71,83
238258,pio89sz,1225,188783,154,71,83
554652,polanski997,1267,195140,154,85,69
68446,remnj,1293,199259,154,76,78
50420,rosjanin2,1240,191064,154,87,67
122474,siwy189,1310,201886,154,75,79
136270,sk00crouzer,1460,224897,154,100,54
370796,sws6624,1184,182392,154,70,84
549611,szym0n29,1219,187839,154,76,78
195747,tomasz423,1396,215092,154,107,47
464,tomcio124d,1242,191354,154,79,75
395980,tpt1536g,1283,197644,154,99,55
35750,uki219,1324,204039,154,100,54
350620,wkw5980g,1485,228777,154,79,75
635382,wound,1565,241139,154,85,69
479407,wpp1180g,1383,213129,154,112,42
318722,zawolin,1353,208493,154,87,67
57939,zepsuccito,2059,317226,154,100,54
2423,19gufi92,1396,213628,153,83,70
309622,239,1475,225715,153,59,94
443804,bnd9457,1274,194954,153,110,43
409039,cck2454g,1214,185803,153,72,81
396641,cgc2986g,1335,204288,153,95,58
119102,chalssus,1305,199674,153,63,90
382881,dorohkla,1547,236779,153,117,36
436092,dts3138g,1452,222193,153,70,83
394629,egzorcysta09,1194,182730,153,71,82
14470,err0r404,1278,195566,153,82,71
634561,gestechmury,1486,227411,153,82,71
273374,gumis2828,1149,175852,153,63,90
271299,hitoshii,1270,194369,153,84,69
404641,hiziol12,1433,219371,153,72,81
63265,humer16,1497,229051,153,77,76
33907,jagust,1436,219804,153,84,69
168793,jarrroslaw,1347,206187,153,91,62
148068,kicek97,1354,207205,153,109,44
45755,kokominodi,1280,195857,153,93,60
271116,lazzz,1293,197935,153,78,75
369583,made0n,1286,196774,153,80,73
481895,mieciuzul,1297,198538,153,122,31
7442,mrzbik,1318,201746,153,70,83
352597,niedomira,1315,201298,153,87,66
265916,nowygh,1239,189590,153,69,84
559712,nudywpracymax,1319,201915,153,99,54
143698,pageram,1241,189934,153,66,87
8156,palloma,1186,181601,153,68,85
20297,pilkarz79,1292,197786,153,89,64
42469,pilotk45,1127,172557,153,61,92
363529,polonez,1599,244769,153,109,44
374305,ptb3806g,1505,230302,153,87,66
400132,punto135,1379,211082,153,103,50
55547,rad1988,1465,224223,153,92,61
300150,sebana12,1565,239593,153,118,35
657459,ssk8877g,1262,193166,153,68,85
644830,szlahu,1302,199310,153,77,76
7310,tiritongaa,1244,190408,153,63,90
516063,tsparrow,1193,182671,153,63,90
55119,w3solychswiat,1450,221892,153,81,72
32709,wojtek10lat,1355,207436,153,89,64
68748,wolfzen,1507,230604,153,97,56
305274,wtc2444g,1290,197448,153,80,73
361185,1224,1328,201952,152,79,73
34513,acmjcf,1396,212319,152,110,42
45910,administrator1,1286,195526,152,73,79
76407,airciocia,1523,231601,152,69,83
26859,ak37a,1619,246147,152,76,76
145112,alexa07,1118,170060,152,41,111
2279,alexrtr,1380,209901,152,84,68
100487,baek,1901,289056,152,112,40
5026,bobson1221,1241,188739,152,53,99
228686,bpw3187,1251,190267,152,92,60
598734,bsg779g,1105,167970,152,43,109
73079,carawela97,1259,191490,152,86,66
55009,ciahtrach,1252,190387,152,75,77
18343,czyzyk61,1325,201489,152,69,83
426871,dcc8618g,1300,197607,152,79,73
114127,edziulka321,1223,185959,152,84,68
56754,filips90,1123,170772,152,53,99
302816,gfs7462g,1170,177964,152,87,65
138376,gool28,1268,192819,152,53,99
28594,jakikwas,1526,232049,152,96,56
39991,jan68usz,1256,190946,152,77,75
128219,klimatyzator5,1278,194344,152,91,61
402149,komspisacja,1538,233779,152,84,68
35496,kono88,1265,192431,152,75,77
146899,ladacznica,1340,203729,152,80,72
581574,lajonheart,1665,253183,152,104,48
115118,lvlagda,1540,234227,152,105,47
394045,m0p,1658,252039,152,99,53
70514,milipati,1167,177420,152,61,91
426742,miqezmeister,1444,219503,152,110,42
52392,mycha201,1245,189289,152,81,71
363527,nbn8436g,1370,208285,152,87,65
107477,nostalit,1421,216036,152,85,67
481272,nwm3904g,1440,219019,152,95,57
5725,pawel1m,1399,212748,152,126,26
132173,pbf4769,1233,187445,152,73,79
176599,pbt6920g,1250,190045,152,85,67
216157,pedroleon,1712,260355,152,103,49
644326,psb1962g,1320,200765,152,77,75
612073,pwg6766g,1404,213417,152,76,76
94094,regulus1,1254,190708,152,67,85
632203,sct5381g,1259,191413,152,87,65
12779,suaby,1396,212293,152,71,81
124363,szymicz,1243,188946,152,73,79
69490,tomusatomus,1268,192823,152,83,69
6693,wielunwks,1372,208617,152,70,82
509601,wmc9252g,1290,196142,152,88,64
640682,xrobot,1484,225686,152,111,41
137908,0duchlast0,1604,242222,151,93,58
22712,ab82,1384,209071,151,89,62
41135,abv,1415,213799,151,65,86
16010,arass,1299,196171,151,72,79
18295,beicuu,1327,200504,151,82,69
141952,biten,1322,199652,151,84,67
120818,danistheman,1466,221380,151,81,70
508052,dbf6951g,1258,189971,151,70,81
65655,dbn4381g,1156,174616,151,25,126
25446,dirkcurly,1580,238656,151,118,33
506515,dks4135g,853,128903,151,0,151
14656,dlaswiat,1675,252983,151,102,49
6647,edzia1980,990,149609,151,23,128
421151,fdm8084g,1325,200203,151,91,60
476409,fns872g,1251,189002,151,84,67
502276,gazowanawoda,1472,222361,151,104,47
83311,gpp7416,1253,189347,151,68,83
238138,grubiana12,1539,232470,151,108,43
174603,gsk7028g,1231,185907,151,68,83
44795,hellsurebet,1897,286468,151,88,63
78121,hubi1950,1365,206263,151,71,80
7825,iglica,1630,246160,151,78,73
97462,kamil11mlody1,1211,183011,151,76,75
362459,kamila874,1111,167816,151,55,96
254797,killmymind,1355,204672,151,68,83
175142,ksawie,1739,262602,151,113,38
19308,lukaso1221,1208,182543,151,75,76
110355,maciejzklanu1,1533,231604,151,85,66
261429,margolka15,1342,202746,151,109,42
7459,mefju93,1412,213324,151,101,50
416316,michal1825,1198,180936,151,84,67
75641,michal2015,1266,191206,151,86,65
67300,milol,1270,191894,151,81,70
131002,miszczumilan,1289,194761,151,92,59
361500,mpt8615g,1330,200837,151,118,33
615364,napalony92,1208,182534,151,68,83
262781,nazgull,1336,201832,151,71,80
40017,olafson,1273,192293,151,106,45
85284,patryk1308,1109,167554,151,39,112
57710,paulina0706,1344,203041,151,93,58
414602,pcn7410g,1327,200424,151,113,38
373107,raichle,1215,183611,151,79,72
68731,ranfon,1551,234341,151,106,45
325297,rapmajster,1361,205521,151,65,86
18056,skejcior21,1222,184634,151,66,85
98429,smerfnaaaaa,1086,164060,151,47,104
540842,swf7177g,995,150298,151,29,122
193863,tomoj1pom,1676,253122,151,100,51
22234,tremilkaa,1116,168620,151,52,99
21328,tygrysek231,1307,197411,151,112,39
263572,ukaaa,1423,214947,151,104,47
41119,wnuniu27,1205,182083,151,71,80
223058,wujek1284,1266,191255,151,81,70
94179,wymagajacagra,1512,228401,151,87,64
402052,yahn,1846,278859,151,114,37
343207,zdania9,1185,179062,151,73,78
253110,zuzia1996,1098,165799,151,12,139
100191,777l,1396,209503,150,115,35
258341,8robert88,1137,170685,150,60,90
21719,adamome,1414,212121,150,77,73
8620,adik17,1474,221103,150,71,79
626373,baoba,1537,230614,150,95,55
23736,bcg6778,1343,201584,150,92,58
525757,bgc1303g,1379,206958,150,83,67
524984,bkm6692g,1102,165445,150,45,105
640543,bratower5137,1477,221565,150,83,67
435474,cnm661g,1326,199045,150,83,67
25308,d0grynainfie,1381,207175,150,75,75
155115,darecki0117,1438,215704,150,90,60
93440,dareks1103,1289,193421,150,85,65
98606,diablicagrrr,1179,176969,150,66,84
477547,dpn6456g,1185,177819,150,63,87
174512,ebone,1010,151505,150,28,122
129771,falszi,1792,268853,150,112,38
25399,faynomathos,1269,190404,150,76,74
614306,gcd5817g,1225,183796,150,76,74
7721,guruluki,1238,185766,150,78,72
275921,janek1983d,1301,195255,150,94,56
1594,jaros1923,1325,198801,150,73,77
122282,justuz,1235,185384,150,69,81
21583,kendzierz1,1362,204368,150,81,69
156571,kgs9041,1330,199549,150,106,44
9071,ksenia,1117,167644,150,42,108
24931,kubelek,1575,236385,150,91,59
87809,lupucupu1,1252,187900,150,69,81
29988,mafiapdg,1597,239617,150,148,2
632728,mbt9938g,1188,178340,150,56,94
26035,meaanima,1238,185711,150,79,71
247644,memoryerrors,1769,265386,150,103,47
285156,mijushi,1290,193536,150,115,35
96564,mjudo,1154,173204,150,86,64
79918,npns,1320,198088,150,75,75
636018,pirania00,1256,188444,150,59,91
377614,pogonlitewska,1350,202528,150,78,72
6550,redgandalf,1671,250681,150,92,58
219554,sdc8198g,1198,179749,150,64,86
152650,sf2k,1163,174537,150,55,95
605871,smoczkus,1329,199405,150,88,62
524369,synelson,1106,165936,150,48,102
258578,tatraman,1428,214294,150,73,77
172102,tgd3643g,1191,178686,150,57,93
265623,tnw7015g,1305,195868,150,95,55
15272,vakarasss,1510,226529,150,73,77
70996,vspakkreska,1466,219916,150,86,64
112188,wafelbar,1342,201318,150,72,78
454076,wtd2210g,1592,238818,150,102,48
378298,zazulex,1493,223994,150,90,60
479987,88rzeznik88,1301,193874,149,74,75
70473,9016,1278,190537,149,76,73
38900,adrian1345,1165,173724,149,57,92
497962,agusiak165,1145,170668,149,52,97
229644,angry11,1392,207485,149,92,57
256718,apache87,1163,173351,149,50,99
18425,asaprockyasap,1673,249345,149,96,53
346670,bcw5724g,1465,218433,149,74,75
577304,bfn6576g,1074,160074,149,45,104
4838,chhinol,1284,191376,149,81,68
174998,ckw7287g,1128,168217,149,50,99
216907,clarus,1276,190217,149,89,60
64883,czarrek87,1237,184417,149,55,94
43191,devastor05,1527,227621,149,78,71
266622,dsc4458g,1045,155845,149,27,122
56687,fabi111,967,144147,149,29,120
645873,fanzolisz,1584,236036,149,101,48
417303,fwk3558g,1210,180417,149,68,81
559083,gbg1335g,1477,220128,149,87,62
32039,gitara24,1248,186028,149,74,75
364501,grajekzbajek,1316,196141,149,88,61
114801,humeninho,1265,188534,149,53,96
630372,hydroactive,1374,204850,149,99,50
33300,ilmah,1370,204154,149,95,54
278766,josuoo,1483,221076,149,82,67
21700,kamil211191,1353,201720,149,92,57
297186,kgk9938g,1168,174037,149,56,93
127996,kikcia1307,1156,172278,149,59,90
112609,kinga74,1084,161593,149,42,107
491737,klamcaadm,1521,226726,149,80,69
136654,klaudunka92,1094,163139,149,46,103
401695,kompromitacja,1599,238262,149,102,47
604866,ksm244,1254,186977,149,78,71
145113,kubeleusz,1283,191261,149,109,40
307472,kucman8,1579,235284,149,127,22
169251,kudziro,1386,206546,149,88,61
486854,luuuzzzzzzzz,1300,193759,149,88,61
270710,m1xn3,1265,188520,149,84,65
113965,mario75nl,1137,169492,149,58,91
105791,marko123,1226,182719,149,84,65
37213,martacin22,1205,179629,149,77,72
11744,michalm05,1399,208463,149,63,86
108809,mishamansoor,1479,220463,149,83,66
73710,mrcliver,1669,248778,149,92,57
554858,mwp6461g,1288,191964,149,86,63
421612,nowywlkp,1263,188207,149,75,74
293640,omegabfl26v6,1364,203352,149,88,61
69326,ouguv,1564,233041,149,91,58
583657,pgn9935g,1243,185317,149,69,80
416674,pmw6837g,1231,183433,149,67,82
46650,pu80,1160,172882,149,50,99
104952,pwp11,1398,208349,149,76,73
99641,qwertyudhkwiu,1321,196964,149,53,96
203161,reddss,1238,184572,149,67,82
383152,redgard555,1319,196641,149,75,74
539379,rezoo,1204,179526,149,57,92
116797,salutuj3,1228,183038,149,64,85
296482,scp2661g,1190,177381,149,61,88
338216,sfn3284g,1337,199326,149,92,57
128465,simas1234,1170,174401,149,57,92
146709,simbad89,1547,230526,149,75,74
107782,skor6615,1574,234575,149,106,43
367551,spk9852g,1188,177064,149,72,77
566380,swillock,1380,205677,149,87,62
26799,sysia1109,1198,178645,149,69,80
28659,taadeo001,1167,173951,149,65,84
571690,tbk1236,1291,192478,149,84,65
648761,tdw5279g,1243,185260,149,77,72
323606,tom6673,1443,215124,149,101,48
86536,vaherr,1350,201298,149,96,53
409238,wojciech1978,1181,176094,149,80,69
124678,xsardas112,1390,207163,149,80,69
110069,zspman15,1393,207597,149,67,82
41039,zybex,1735,258576,149,98,51
24403,39to,1285,190232,148,82,66
499014,aduus96,1174,173868,148,73,75
1853,atram1789,1112,164651,148,53,95
270555,cff3332g,1453,215145,148,97,51
476334,claud85,1148,169957,148,51,97
790,cygan1122,1322,195671,148,68,80
167657,czerwonna,1559,230823,148,87,61
183033,dam1do1dzioba,1366,202269,148,63,85
498072,dominik999,1122,166120,148,62,86
5750,dudi82,1451,214837,148,97,51
330880,dwf5083,1151,170479,148,57,91
435258,flagaxd,1109,164232,148,36,112
96073,fryderykvangog,1547,229003,148,78,70
378949,fsg650g,1271,188170,148,87,61
461371,ggb3440g,1380,204288,148,100,48
339183,gitarasiemaa,983,145569,148,37,111
372550,gtt2084g,1225,181369,148,62,86
31989,jakalama,1305,193146,148,65,83
339162,k0rekk,1213,179576,148,62,86
252759,k1n0,1354,200454,148,84,64
618635,kamilaeu,1177,174320,148,65,83
485516,kcf9353,1328,196544,148,99,49
9606,kronos9643,1259,186395,148,94,54
98456,logitecht,1545,228767,148,76,72
428358,mar3b,1280,189499,148,79,69
2124,marcin19830,1300,192498,148,79,69
335649,marz2773,1507,223036,148,95,53
435180,mat1789,1303,192889,148,62,86
1810,mati0206,1069,158356,148,67,81
651504,mbb8314g,1309,193805,148,94,54
166696,mdm4235g,1221,180774,148,65,83
148255,mdr86,1231,182331,148,72,76
4528,monia5678,1270,188040,148,78,70
341668,mpn6968g,1287,190606,148,80,68
107060,naraf,1626,240693,148,79,69
616279,ncm5870g,1390,205773,148,95,53
426548,pasieka7,2146,317674,148,105,43
25666,plmichas,1462,216421,148,96,52
311482,pom22,1345,199106,148,71,77
376,rasiek82,1286,190412,148,78,70
475925,realek1,1342,198616,148,82,66
583805,repostokdeath,1245,184387,148,80,68
333032,rezi2,1209,179066,148,67,81
344305,rzulty,1703,252045,148,147,1
97236,sajan13,1303,192848,148,67,81
313667,skp805g,1289,190872,148,82,66
118297,skreatch,1260,186615,148,62,86
570283,solider,1754,259652,148,99,49
132596,ssyynnuuss,1238,183277,148,75,73
551218,swiadekjehowy,1382,204556,148,77,71
11614,sztaba31,1394,206384,148,95,53
165551,szybkimuniek,1473,218073,148,88,60
326330,t50,1314,194484,148,62,86
595585,takit,1541,228116,148,83,65
582445,tcm1532g,1369,202666,148,91,57
279095,teresa611,1118,165465,148,54,94
133475,the99tek,1168,172922,148,84,64
22233,titplease,1236,183000,148,96,52
561205,tpm5849g,1221,180721,148,71,77
180750,v0lej,1615,239057,148,83,65
935,valfar,1498,221837,148,78,70
98231,xxx7799,1298,192205,148,94,54
10685,zanzara,1462,216410,148,100,48
122489,zerocult,1601,237011,148,132,16
94020,zielony198,1135,168020,148,40,108
226526,zuzieel,1328,196550,148,82,66
418460,18oonext,1383,203409,147,75,72
107388,abcabcabc1231,949,139516,147,16,131
2893,afirq,1237,181873,147,70,77
58356,andrzejm1970,1220,179464,147,72,75
307412,antyqwerty,1658,243807,147,77,70
69506,arongus,1385,203667,147,100,47
476159,bestiazewscho,1480,217701,147,82,65
6295,bh85,1272,187088,147,76,71
50693,blackangelek1,1114,163860,147,44,103
633025,bsk4903g,1398,205510,147,114,33
580936,cdt6551g,1096,161174,147,48,99
1523,cilipek,1250,183862,147,71,76
150123,daffcio93,993,146077,147,18,129
70169,daro240792,1288,189479,147,81,66
140506,diarrhoea,1531,225109,147,84,63
46724,dikom,1206,177348,147,63,84
323696,dilujemy,1524,224063,147,96,51
637049,dobryziomek42,1180,173506,147,77,70
393971,donjuanos,1612,237035,147,97,50
144773,frager1,1303,191601,147,69,78
244308,gen55,1332,195844,147,99,48
558281,gnk2234g,1319,193911,147,77,70
427040,gregorius102,1088,159956,147,40,107
142835,gsp1909,1283,188603,147,108,39
447034,h1t73r,1176,173007,147,62,85
82734,ibrahiimovic,1882,276687,147,86,61
383294,iimpossible,1179,173320,147,71,76
14870,jacksqarrow,1331,195787,147,80,67
249029,keymil,1123,165161,147,36,111
29768,kickboxer32,1303,191627,147,84,63
46628,koutondziad,1377,202538,147,92,55
568120,kps8278g,1407,206907,147,86,61
82388,lesia112,1193,175401,147,56,91
40536,lopsa2086,1238,182106,147,81,66
618241,maatti,1252,184131,147,69,78
1369,maciej1002,1340,197084,147,69,78
247200,marcinek1986,1252,184082,147,86,61
292,marqqv,1287,189252,147,75,72
47662,melinka636,1410,207402,147,86,61
163195,mlodyy79,1126,165564,147,43,104
4922,namrejka,1340,197092,147,78,69
2518,niszczyciel64,1388,204142,147,96,51
17873,nitrusbrio,1318,193772,147,87,60
511823,nsf6770g,1244,182957,147,71,76
137728,obew,1677,246659,147,91,56
183969,ogiernum1,1393,204792,147,97,50
396537,pdk9276g,1219,179318,147,62,85
5384,pyxol1,1342,197355,147,82,65
202944,quaresma19,1265,185968,147,79,68
196232,sarenek,1194,175627,147,60,87
38778,speeeed2,1520,223481,147,94,53
402964,sweetfocia,1300,191184,147,86,61
10472,szusz2,1387,203950,147,114,33
229085,szymson80,1171,172160,147,64,83
468461,tbt1203g,1274,187302,147,69,78
162832,tfw843g,1298,190883,147,114,33
313673,tpn1556g,1196,175884,147,63,84
215325,umieszpogrywa,1387,203989,147,90,57
540311,wct5085g,1304,191701,147,103,44
396630,wdm9531g,1345,197804,147,103,44
621683,xoxolu01,1214,178532,147,62,85
405799,yuuta,1195,175771,147,83,64
82707,zimnyyyydran,1321,194321,147,90,57
302472,11margit11,1735,253332,146,111,35
349462,5511,1457,212794,146,87,59
120404,adatiel,1441,210404,146,83,63
150897,agacia2139,1281,187140,146,111,35
395872,btc5601g,1444,210869,146,118,28
1362,bylytrener,1421,207481,146,84,62
483459,cmd7461g,1271,185685,146,83,63
195753,dogbolter,1458,212997,146,90,56
235303,eddkowy,1331,194336,146,87,59
181032,endrju87,1360,198672,146,77,69
336002,fan1234,1189,173690,146,63,83
343030,ffw9828g,1221,178350,146,72,74
520423,fmp490g,1230,179614,146,80,66
122934,fomu,1330,194195,146,94,52
630415,fst9350g,1423,207762,146,92,54
213339,golabpawel198,1204,175890,146,59,87
85125,guciu149,1185,173150,146,78,68
281630,jacsos,1268,185166,146,89,57
126237,jeeanvaljean,1316,192236,146,84,62
113423,kacperek801,1062,155083,146,6,140
497963,kacperniuski,1275,186236,146,100,46
224941,kowal0040,1177,171957,146,59,87
53843,krysztalek9,1158,169109,146,53,93
390042,mario248,1244,181628,146,78,68
40078,mefistosedes,1445,211078,146,84,62
8902,miadan,1225,178874,146,71,75
561218,michal3012,1187,173439,146,66,80
58839,michalek13,1230,179627,146,83,63
119840,miras9021,1159,169258,146,52,94
282126,mm410,1527,222994,146,96,50
222490,mst7929,1259,183843,146,74,72
115864,nejos,1504,219647,146,85,61
46149,nosu,1385,202322,146,123,23
36201,patyczyslaw88,1133,165452,146,63,83
395498,pdt8274,1186,173245,146,71,75
487728,piniuu9,1247,182115,146,68,78
305887,pom21,1430,208868,146,67,79
342510,przeegralem,934,136427,146,3,143
208319,sgk8735g,1346,196647,146,98,48
112737,shooterhoi,1192,174139,146,49,97
436792,sma777,1278,186717,146,100,46
513435,speco24,1373,200475,146,89,57
596951,stc6031g,1222,178487,146,68,78
1292,swibno,1475,215489,146,106,40
454477,takise,1443,210716,146,97,49
491286,tarnov,1395,203733,146,101,45
117370,tgop,1336,195164,146,76,70
436008,wicent,1285,187735,146,100,46
33576,wiktorw85,1279,186809,146,74,72
94771,xkzky,1214,177301,146,62,84
281323,6sty,1487,215687,145,97,48
160144,andolini1891,1351,195958,145,70,75
56086,anettt91,1193,173114,145,69,76
330879,asasyn9008,1232,178701,145,88,57
153796,badkarmaa,1341,194452,145,85,60
515773,bgp4665g,1283,186167,145,84,61
366,borys0f,1181,171360,145,78,67
390560,chaters,1134,164543,145,53,92
327017,czescjestemxd,1252,181651,145,74,71
238976,denisek82,1246,180683,145,95,50
150122,dominika011,1339,194200,145,121,24
411760,dominiula,1235,179133,145,81,64
143078,estefanio,1377,199684,145,76,69
116355,felisia,1379,200092,145,96,49
29919,fliptus,1225,177659,145,76,69
138254,ftve,1284,186249,145,76,69
148806,gacci88,1236,179250,145,58,87
277862,gcc5116g,1194,173204,145,57,88
545898,gct3725g,1226,177875,145,77,68
437904,gds1235g,1267,183829,145,71,74
68265,gizyzz,1554,225342,145,87,58
852,harcownik2,1531,222084,145,110,35
246110,kicikici21,1278,185450,145,73,72
1065,kubix94,1423,206437,145,75,70
258971,lacus11,1005,145803,145,11,134
507980,liquid,1573,228135,145,86,59
1805,maciejsko,1383,200586,145,124,21
396831,madoq,1140,165318,145,50,95
176702,mali08,1125,163171,145,62,83
516301,marmir7310,1479,214589,145,89,56
562084,mkg5337g,1313,190403,145,87,58
215920,mts64,1283,186068,145,91,54
211776,nomercy07,1300,188601,145,89,56
556469,nps4211g,1339,194224,145,80,65
413194,okaro,1253,181780,145,85,60
481802,oktaawka,1149,166687,145,56,89
11892,olaff32,1338,194076,145,95,50
247545,olszowka36,1324,192008,145,88,57
91826,onaogien,1310,189999,145,91,54
57553,panjakob,1043,151257,145,45,100
491061,pietroo,1314,190634,145,85,60
205592,ppn4493g,1218,176744,145,59,86
2894,prokaszana,1250,181371,145,82,63
89708,przel0n,1777,257794,145,106,39
479424,pws7064g,1435,208194,145,82,63
20926,ringoo,1210,175484,145,79,66
98871,rruudaaxd,1046,151812,145,29,116
58592,sadede125,1221,177176,145,81,64
78318,sajmon1999,1267,183846,145,85,60
179344,siemasziom,1334,193475,145,62,83
111,skorup7366,1577,228778,145,94,51
38034,sukinsyn,1450,210301,145,111,34
501736,swm9645g,1170,169696,145,61,84
214651,szczuron,1328,192598,145,76,69
194026,tomekm984,1299,188424,145,86,59
106162,yatotools,1337,193972,145,81,64
321707,youstine,1233,178850,145,73,72
22978,zelek1997,1135,164614,145,55,90
59559,zimny1983,1204,174660,145,75,70
430321,2005kowal,1434,206510,144,77,67
209989,aadams7,1268,182699,144,80,64
503531,bananakik,1649,237459,144,91,53
402414,bumszakalak,1494,215222,144,92,52
148953,bwb6326g,1364,196422,144,80,64
102158,chwytak1,1273,183326,144,65,79
6976,danielek129,1268,182726,144,86,58
292783,ddg7717g,1389,200124,144,77,67
505913,ddn7824g,1312,188958,144,86,58
514156,domii93,1116,160769,144,30,114
239050,dominika876,1230,177146,144,72,72
151198,elcyd,1457,209889,144,117,27
449074,fajnapaulina,1211,174422,144,73,71
56983,faker1x1,1621,233466,144,103,41
592298,fpn1665g,1277,183947,144,77,67
335654,fr4jer,1216,175222,144,81,63
366683,freqaz,1628,234564,144,108,36
624336,gdk7212g,1206,173719,144,62,82
445356,gnc8595g,1290,185783,144,76,68
69608,gniewek,1264,182063,144,77,67
112563,gosiunia1969,1186,170888,144,53,91
1374,hulanekgaming,1321,190352,144,99,45
35352,idekk92,1181,170091,144,58,86
392768,invincibile,1237,178153,144,99,45
68821,kajtii,1250,180115,144,86,58
274314,kamczikss,1199,172698,144,74,70
227068,kamilboss2015,1234,177720,144,65,79
33251,kasica163,1242,178860,144,91,53
576839,lew5552,1309,188566,144,90,54
33250,lobuziaku,1150,165732,144,53,91
145434,m2g21,1182,170300,144,71,73
253109,maniek7014,1484,213716,144,132,12
63025,marcin3kkk,1266,182339,144,72,72
63319,maszewo10,1131,162996,144,48,96
475355,mcg1057g,1360,195844,144,93,51
415754,menak1015,1495,215288,144,89,55
267761,mir410,1516,218433,144,98,46
242512,miruss71,1313,189089,144,81,63
365796,miuradg,1337,192666,144,101,43
98922,msd4478,1203,173358,144,82,62
254465,muc13k,1347,194055,144,112,32
129744,mystamagysta,1251,180238,144,85,59
229282,nowytu22,1101,158659,144,34,110
536287,nsn8274g,1306,188170,144,86,58
121190,p03,1689,243323,144,91,53
650992,patrys1987,1165,167808,144,57,87
161122,piesikot8,1211,174471,144,72,72
420186,pindol69,1158,166857,144,56,88
42861,przeh,1306,188091,144,85,59
397257,rolnik5,1432,206306,144,81,63
279325,songoku,1946,280363,144,119,25
451944,stoprobolt,1243,178998,144,68,76
168900,sweetmaryjane,1621,233555,144,87,57
71862,tokzoneee,1359,195734,144,108,36
238564,wwp7357g,1274,183477,144,69,75
315122,xxokwezdxx,1221,175938,144,93,51
24746,yates24,1245,179371,144,73,71
237037,aethis,1405,201036,143,79,64
262329,agrafkakiller,1163,166420,143,58,85
1718,apaspe,1689,241572,143,78,65
324228,blackhawk191,1322,189049,143,88,55
83281,bombaodup,1207,172654,143,72,71
461814,caban,1569,224418,143,80,63
624252,ccp7584g,1268,181436,143,83,60
471427,cfm3656g,1301,186183,143,79,64
486823,csk2889g,1268,181344,143,84,59
374068,ctt3091g,1312,187718,143,71,72
2206,czortowski,1299,185811,143,80,63
614871,damian21nk,1194,170873,143,73,70
13180,elosiemano,941,134680,143,21,122
114288,epek37,1045,149520,143,27,116
566374,facetzwidlami,1278,182854,143,75,68
377240,fkp5515g,1230,175890,143,78,65
606984,fly1988,1267,181189,143,84,59
596140,fnk785g,1268,181428,143,77,66
327381,gkw4315g,1253,179208,143,69,74
59965,gregor3030,1233,176422,143,87,56
9063,hubert1925,1394,199440,143,73,70
49419,huuulk,1765,252536,143,88,55
600750,kfm5899g,1379,197282,143,87,56
278301,kkt5252g,1262,180527,143,86,57
341991,kostek00,1112,159105,143,43,100
7148,kowal91,1616,231162,143,77,66
2843,kracha1,1559,222987,143,84,59
425881,krolik21,1247,178346,143,99,44
285157,kyraaa,1115,159576,143,35,108
619538,levy11,1230,175926,143,57,86
127628,lubietrawke1,1052,150551,143,32,111
82192,mabex,1309,187209,143,83,60
62692,maksymilian26,1340,191669,143,99,44
167099,mckondziu,1205,172379,143,76,67
123135,migotka50,1217,174086,143,85,58
426031,ngf9185g,1175,168115,143,57,86
478314,nks1229g,1327,189870,143,89,54
258458,ostrykozak,1452,207756,143,99,44
23567,paluszek7,1378,197088,143,72,71
28353,petalo,1378,197178,143,96,47
97619,pietia1992,1281,183294,143,70,73
4479,poziomkaaa87,1233,176323,143,68,75
11479,przemas30,1314,187929,143,64,79
44622,przeznaczonaa,1207,172716,143,69,74
596921,pwc1044g,1362,194816,143,72,71
18684,pyska2345,1371,196183,143,97,46
105848,q0v,1671,238987,143,89,54
515189,rembix7,1368,195750,143,63,80
306412,rolnik4,1435,205329,143,98,45
153574,rs8,1584,226530,143,85,58
194401,scp3737g,1492,213445,143,94,49
372558,sdv78yijo31df,1304,186479,143,81,62
296887,stuugames1,1143,163537,143,42,101
214093,ttr991,1415,202404,143,86,57
65114,weedz,1253,179202,143,58,85
315323,wfw8973,1177,168318,143,67,76
239169,wujdurzo,1384,197986,143,94,49
433986,zawszeprawy,1411,201773,143,71,72
490041,0nlive,1467,208358,142,84,58
123763,4forfiter4,1453,206450,142,76,66
19418,ankat89,1223,173678,142,60,82
200935,antozaur,1140,161896,142,49,93
18960,arsa1234,1290,183210,142,81,61
514726,bbp6638g,1236,175640,142,71,71
96186,checov,1325,188283,142,78,64
851,cichym17,1428,202889,142,74,68
547926,cwp5204g,1295,183988,142,82,60
217375,donkamillo30,1332,189198,142,89,53
266624,driverkms,1451,206106,142,87,55
516748,flyhigh,1650,234338,142,75,67
455767,ftp3935g,1078,153153,142,37,105
166950,gentel,1562,221891,142,91,51
382768,guciii,1695,240768,142,99,43
200936,hanscastorp,1259,178904,142,93,49
6940,hiiszpankaa,1236,175541,142,81,61
324210,isco5,1310,186141,142,67,75
54624,jasiek2014,1112,157972,142,45,97
216144,kcp0516,1145,162660,142,42,100
557904,kdp5540g,1252,177832,142,70,72
128206,mac5800,1326,188391,142,89,53
147380,maggie1994,1097,155865,142,45,97
399189,menak27,1473,209243,142,85,57
561571,mkn8998g,1192,169331,142,67,75
561239,mpbd,1264,179555,142,78,64
271902,nataqatan,1194,169648,142,63,79
390552,nmc9521g,1334,189471,142,84,58
280855,patrycja9611,1138,161664,142,48,94
110253,procencik,1375,195345,142,94,48
84914,rekinekk,1375,195386,142,91,51
203522,robson97,1371,194709,142,55,87
1321,sbn3376,1197,170073,142,60,82
582589,sct6469g,1174,166808,142,54,88
35181,sienkus,1251,177766,142,56,86
435465,stukmaken,1148,163093,142,59,83
387033,tdm7977,1248,177329,142,77,65
102056,thecabmaniac,1164,165429,142,52,90
50089,torres120,1575,223744,142,75,67
597,vyspa,1484,210760,142,65,77
422992,wpk9382g,1338,190074,142,85,57
169361,wrednamala20,1305,185446,142,76,66
173283,1groszzasms,1762,248568,141,79,62
239830,29c,1286,181450,141,74,67
258944,2czarnamamba7,1144,161345,141,48,93
309628,aagata17,1217,171714,141,71,70
242516,agapo,1450,204483,141,90,51
134565,aro600,1248,176034,141,63,78
286321,aspire14,1135,160101,141,34,107
514567,bbm8537g,1211,170879,141,70,71
122902,bpk1133,1123,158421,141,51,90
23880,caprio11,1468,207005,141,108,33
385872,cgt6457g,1109,156446,141,39,102
89551,corkatanieli,1194,168414,141,67,74
466,cugiel95,1243,175395,141,83,58
356818,dejvvi,1280,180534,141,72,69
375484,deo87,1345,189687,141,79,62
27464,dioderptak27,1261,177892,141,66,75
373135,doris0018,1222,172358,141,59,82
383795,dpc1511g,1230,173438,141,70,71
358,drjameswatson,1465,206649,141,68,73
90773,dzolo73,1286,181345,141,99,42
40677,ea7,1429,201624,141,82,59
635843,echyou,1499,211390,141,83,58
61842,eugeniastefan,1113,156980,141,41,100
109280,fkt4852,1216,171475,141,54,87
313395,fpg5643g,1370,193203,141,84,57
37202,ggr1518,1211,170788,141,59,82
119583,indy9,1427,201248,141,74,67
235605,jagielnik,1315,185456,141,72,69
563315,jahamato,1345,189741,141,72,69
512695,jakubiec4,1306,184275,141,102,39
159630,japirate777,1218,171760,141,78,63
17213,kaaaaaa,1468,207090,141,91,50
1382,kaamil1234,1295,182646,141,73,68
2600,karol1104,1163,164017,141,63,78
521675,kdw7453g,1393,196505,141,81,60
186741,kubzonis,1167,164574,141,63,78
204606,kyniek1988,1229,173416,141,64,77
237642,legos0987,1279,180448,141,110,31
211614,lewatywa,1443,203598,141,74,67
61711,lizak9191,1327,187214,141,87,54
5146,magell,1223,172582,141,63,78
4670,malynio9,1350,190465,141,72,69
337476,melanholiczka,1224,172674,141,73,68
284774,mustaq,1236,174290,141,79,62
351893,obornikmam,1469,207170,141,97,44
561977,pajonk13,1264,178311,141,69,72
562196,precyzjaxxx,1356,191336,141,77,64
41885,pylo93,1107,156102,141,46,95
654149,scn4335g,1396,196874,141,83,58
42324,suhy12,1208,170394,141,83,58
277659,superasny,1472,207652,141,82,59
506710,ukasz1908,1241,175038,141,64,77
34353,wigilijny2014,1718,242372,141,102,39
346100,windows1998,1487,209668,141,58,83
366751,wnf8727g,1254,176951,141,64,77
410878,wtn7741g,1236,174286,141,70,71
45939,yossiaq,1432,201934,141,74,67
112444,zadymione,1659,234027,141,90,51
181922,007mateusz007,1542,215890,140,64,76
448215,1goodgamer1,1217,170419,140,79,61
36568,28o9l3,1182,165527,140,57,83
140166,96olcia96,1104,154633,140,39,101
79201,andrzejniemow,1198,167850,140,56,84
23479,blonde1234,1232,172503,140,96,44
261160,cepek05,1221,170997,140,55,85
456010,ckn3103,1374,192383,140,72,68
50487,cooola121,1465,205142,140,86,54
334358,csi100crazy,1478,207002,140,77,63
440210,d4nte,1503,210538,140,80,60
74343,dawidjuzik,1353,189534,140,107,33
246251,dbsk,1428,199927,140,65,75
97847,dmadvice16,1318,184548,140,92,48
389159,dmt9484g,1105,154764,140,39,101
264684,emilrom,1388,194416,140,113,27
114320,fotofill,1154,161630,140,24,116
8694,funaki456,1196,167464,140,51,89
270330,gboy01,1239,173594,140,72,68
224614,gfyvgv,1182,165574,140,65,75
115257,grajciekurde,1618,226579,140,77,63
151049,grelu80,1342,187882,140,86,54
656537,gst9438g,1386,194106,140,103,37
194537,itsjustbeginn,1325,185503,140,70,70
33031,iwetka,1165,163141,140,57,83
9427,janusz1997,1224,171403,140,68,72
409370,juzsezygtem,1505,210727,140,82,58
23501,kallyne,1097,153704,140,47,93
98118,kelowskyyy,1279,179103,140,61,79
442283,kkg2147g,1493,209113,140,122,18
475346,kkk2204g,1369,191744,140,89,51
278620,klxx,1257,176102,140,88,52
106352,krzysiekb200,1237,173272,140,58,82
185696,kubano7,1166,163344,140,55,85
42604,kudlatyx,1218,170632,140,63,77
661435,laestrella,1269,177769,140,63,77
100,lensss2,1550,217129,140,64,76
271,lordinio,1302,182302,140,67,73
349434,madonna1509,1303,182467,140,83,57
9733,marcelek13,1195,167405,140,52,88
238690,marijuanaa,1439,201539,140,83,57
202116,mario0377,1316,184284,140,94,46
3830,mateuszs28,1513,211866,140,76,64
226147,maver15,1135,158937,140,54,86
540454,mfg763g,1369,191667,140,102,38
86224,mlodyzrebak,1123,157354,140,50,90
221401,npt1817g,1291,180846,140,79,61
561884,ntm4532g,1203,168559,140,70,70
373407,pewnakasa,1131,158355,140,45,95
162340,piyrdolato,1309,183395,140,67,73
87894,pyrytyn,1233,172688,140,68,72
609391,skc9233g,1469,205665,140,97,43
83383,spyder81,1264,177037,140,69,71
557915,sudeciak,1315,184156,140,77,63
268715,sweetgabi,1235,172964,140,84,56
72945,tederap,1257,176104,140,81,59
650209,templarian,1316,184344,140,89,51
378948,tpd9489g,1250,175123,140,83,57
251901,ttf832g,1261,176635,140,64,76
493260,ttm7215g,1367,191474,140,68,72
42127,tylkoatakuje,1485,207984,140,100,40
42687,tytus,1684,235899,140,79,61
349607,wbp1815g,1392,194970,140,82,58
300750,wpk2093,1204,168584,140,76,64
159325,zagorsky,1267,177388,140,71,69
461131,zolyniak85,1281,179389,140,65,75
336682,66szatan66,1181,164251,139,56,83
102151,alien92,1194,166045,139,46,93
375633,arti1993,1423,197854,139,78,61
62207,belde,1238,172126,139,75,64
385067,blacklion91,1393,193730,139,80,59
316253,blacktusiak,1115,154991,139,42,97
75788,blaziren,1249,173668,139,83,56
170900,borys22m,1364,189725,139,91,48
337601,bsk7237g,1204,167437,139,61,78
488585,bsn318g,1199,166724,139,59,80
94427,djbabka,1403,195112,139,111,28
158277,dsw2221g,1312,182474,139,81,58
408879,dwf6010g,1479,205643,139,79,60
60386,emilka850,1142,158791,139,63,76
312796,ewelina9004,1406,195483,139,70,69
237977,exceptionnel,1371,190671,139,92,47
19767,francek1988,1341,186534,139,75,64
3683,franek196767,1301,180926,139,69,70
538415,genowefa1234,1198,166542,139,84,55
6913,gorzkabeczka,1623,225664,139,95,44
38597,inomushis,1167,162331,139,61,78
308230,iphonepati,1329,184863,139,87,52
326504,irrolek,1246,173249,139,72,67
87391,izecson,1281,178166,139,74,65
310222,kajfjsjznxjjd,1455,202281,139,131,8
127928,karolek6,1206,167649,139,66,73
430656,kkg9625g,1123,156102,139,47,92
61202,krystek55,1097,152530,139,39,100
16529,leonetta1234,1303,181226,139,80,59
59397,lilalouy,1070,148820,139,34,105
35542,luzuaga,1250,173875,139,75,64
633309,marcinoslaw,1116,155126,139,45,94
240377,matrix00380,1342,186648,139,70,69
592856,michalek1988,1180,164040,139,55,84
419029,mmm6260,1028,142986,139,19,120
16983,mpr8554,1064,147978,139,31,108
91668,oczko26,1276,177379,139,80,59
105502,oliwtf,1119,155638,139,55,84
80122,olucha28,1240,172377,139,75,64
162021,patrycja0199,1272,176826,139,79,60
276136,pbd1785g,1267,176234,139,87,52
138509,ppn481g,1253,174291,139,72,67
77397,psychofan77,1284,178580,139,71,68
474744,pwb3414,1349,187625,139,69,70
567657,raf006,1368,190290,139,78,61
444264,rafal72c,1195,166227,139,59,80
463695,realfanklub8,1460,202940,139,85,54
90362,rmiazga,1353,188145,139,118,21
400588,smerfiaczek25,1503,209009,139,94,45
101979,sultanlechtac,1226,170447,139,63,76
81507,szambonurek27,1189,165338,139,49,90
336663,tfn544,1180,164121,139,66,73
578686,tritsusi,1226,170426,139,76,63
20508,unia48,1070,148814,139,31,108
2362,vandalism91,1520,211316,139,79,60
90363,weram,1046,145455,139,21,118
427963,0olenka,1296,178957,138,71,67
19378,10miki10,1222,168705,138,60,78
643583,8pietnastek,1667,230051,138,88,50
5596,agata2608,1153,159124,138,56,82
95834,artista27,1114,153847,138,45,93
125457,asdf99,1360,187807,138,100,38
390,aviachi,1381,190609,138,83,55
90580,bockor262,1387,191479,138,92,46
23760,boozezywy,1256,173396,138,96,42
584120,bumar,1246,171954,138,62,76
432630,caarlsberg,1500,207118,138,84,54
188059,ccp3625g,1271,175400,138,73,65
16129,centaur81,1388,191572,138,79,59
269929,cnm6342,1220,168468,138,68,70
62683,codghost,1766,243811,138,85,53
175120,cvxcvx,1267,174888,138,65,73
6549,czapikss,1353,186848,138,70,68
4610,derej1233,2090,288466,138,72,66
514502,dfk647g,1377,190128,138,87,51
135606,doda502,1223,168813,138,63,75
368091,donzulas,1529,211111,138,81,57
406415,dsc6510g,1313,181252,138,84,54
78460,dzumper,1167,161110,138,64,74
242118,edgeplus,1286,177542,138,55,83
421209,ewelcia0507,1231,169958,138,62,76
402102,fdk4653,1120,154628,138,46,92
355094,fkd7637g,1304,180076,138,78,60
108184,forte34,1526,210614,138,112,26
494911,ggg49,1411,194752,138,116,22
197320,gmt5353g,1345,185692,138,88,50
578357,gnw3299g,1383,190953,138,91,47
42882,grek2000,1239,171071,138,67,71
25541,harrystyle,1338,184732,138,69,69
94724,iu8,1536,212077,138,86,52
3857,jarkenss,1406,194123,138,67,71
54601,judymis,1349,186285,138,77,61
27937,k2wisnia166,1290,178039,138,77,61
490152,kalifat1305,1498,206807,138,95,43
324735,kasper9451,1204,166276,138,68,70
355057,kenia92,1336,184378,138,80,58
280,khakikhaki,1230,169847,138,81,57
534004,kkp2639g,1288,177840,138,92,46
8410,kociak1016,1430,197341,138,85,53
282599,kolejnosc,1711,236217,138,94,44
577280,kotekeliza,1074,148234,138,34,104
534124,mmatrix,1197,165302,138,48,90
537297,mng1189g,1123,154974,138,47,91
604310,mtp694g,1204,166235,138,53,85
562739,naco,1229,169605,138,69,69
122186,nbd9106,1074,148296,138,42,96
457023,nervous90,1224,168927,138,67,71
212221,ngc3999g,1639,226250,138,96,42
22096,nietypowynick,1424,196531,138,76,62
590148,nowogrodziec,1286,177547,138,65,73
112668,oleandra1000,1147,158362,138,60,78
90463,paluch1414,1325,182914,138,91,47
492751,pcc9167,1410,194709,138,70,68
195535,piotr0629,1418,195782,138,107,31
11961,piotrek263,1207,166682,138,67,71
2439,posejdon2,1315,181591,138,74,64
55355,prochcialke,1460,201532,138,65,73
277539,rafalkox,1297,179069,138,84,54
51708,rowrybnik18,1308,180632,138,76,62
109454,rudy,1852,255650,138,111,27
189853,rydz91,1183,163363,138,64,74
386295,s8vark,2705,373304,138,61,77
475836,sdf207g,1521,210033,138,109,29
21675,siala1,1521,210005,138,80,58
549698,sms7496g,1520,209780,138,91,47
642007,stf3614g,1459,201350,138,127,11
353610,tadek090,1164,160672,138,51,87
425811,termik30,1351,186466,138,76,62
76021,tojapaula,1341,185189,138,81,57
407483,trecnutrition,1356,187256,138,98,40
561033,wkf3450,1199,165531,138,52,86
5099,yano111,1233,170211,138,71,67
278260,0060,1472,201728,137,103,34
149163,30miksokret,1262,173014,137,59,78
193295,adasmasa50,1294,177400,137,82,55
390517,alvus,1192,163335,137,59,78
109318,basiulka0612,1038,142323,137,29,108
623724,bondziaq,1386,189979,137,72,65
118911,cdwwwe,2027,277746,137,80,57
62016,cilun48,1160,158977,137,55,82
68637,ewing80,1338,183401,137,65,72
390477,ffm4297g,1254,171909,137,77,60
120370,gangalbanii25,1133,155272,137,78,59
4559,geye,1176,161125,137,60,77
156640,gracz0o7,1545,211666,137,69,68
274385,grankov,1275,174723,137,74,63
251786,gripsi,1248,171036,137,74,63
389921,gtb3182g,1256,172195,137,70,67
539800,herrstamper,1437,196962,137,81,56
8751,hydethepanda,1142,156587,137,46,91
74795,jabolpan81,1304,178679,137,70,67
112086,justynaa111,1130,154879,137,69,68
245093,karolinuna,1511,207076,137,97,40
295147,kksdamian,1412,193505,137,94,43
596769,kraftt,1638,224438,137,87,50
359214,kulus708,1137,155852,137,41,96
298901,ladylady123,1201,164644,137,60,77
273930,lecho,1562,214107,137,82,55
93607,mareck31,1257,172258,137,50,87
136670,marzen97,1129,154803,137,40,97
2505,matii50,1316,180377,137,66,71
77228,metalheadgirl,1213,166284,137,65,72
91519,mikonewpowrot,1301,178286,137,69,68
45362,minotek,1475,202134,137,83,54
39795,nasumi,1312,179783,137,75,62
39611,nbg4923g,1249,171165,137,66,71
561506,nowicjusz,1453,199110,137,88,49
390717,ntb3658g,1370,187741,137,87,50
387525,paatryk,1385,189828,137,103,34
4357,papierosy66,1137,155826,137,41,96
98637,pejotek,1247,170970,137,55,82
467657,proorokp56,1289,176667,137,83,54
271160,rockguy,1494,204787,137,86,51
476583,sbk8761g,1191,163182,137,55,82
32422,sebastek09,1349,184904,137,74,63
333822,sgp9477g,1315,180170,137,60,77
258855,sks8258g,1372,187972,137,93,44
1141,slawek37,1367,187386,137,77,60
27023,spychal9955,1297,177772,137,77,60
463215,ssd4699,1294,177281,137,63,74
42398,szakalp1,1121,153618,137,33,104
100059,szakul1,1144,156738,137,45,92
159635,tomaj,1803,247089,137,99,38
344987,trafka1989,1254,171897,137,71,66
96772,uqq,1229,168468,137,62,75
17950,waldek12346,1369,187669,137,91,46
498073,wsk6941,1162,159303,137,70,67
49843,xxboberxx,1160,158992,137,66,71
487337,0kenabe,1674,227726,136,95,41
313029,1961falubaz,1675,227905,136,75,61
259276,2my1game,1390,189092,136,78,58
72752,andrreeaa,1843,250727,136,112,24
50754,badboylukas,1402,190708,136,63,73
355034,baton231,1273,173181,136,88,48
117761,bociekk,1215,165255,136,71,65
308097,cansas,1779,242045,136,93,43
1081,cmghost,1214,165171,136,68,68
50591,concacaf,1471,200064,136,70,66
288262,dawtur,1372,186678,136,87,49
299874,dcf8253g,1408,191600,136,93,43
116082,dss797,1220,165985,136,62,74
37126,duchowomocny,1676,228008,136,79,57
57440,eutan,1460,198658,136,77,59
561841,fsc3294g,1250,170024,136,55,81
371566,ggs7398g,1452,197590,136,84,52
141158,gimbusowie,1279,174047,136,67,69
271139,gmp498g,1228,167137,136,65,71
57054,gogo1801,1252,170366,136,75,61
416824,gosiak7824,1198,163043,136,53,83
60243,grzechu5510,1300,176827,136,67,69
254936,grzes999,1219,165879,136,69,67
73323,gulek2007,1277,173684,136,58,78
33963,jasiekbuk97,1345,183055,136,79,57
101388,juhanot,1369,186245,136,84,52
50396,julaaa767,1173,159566,136,52,84
181184,justadream9,1412,192060,136,66,70
11360,kacperantk,1217,165638,136,72,64
266460,kaiser11,1220,165996,136,71,65
590048,kmn6280g,1354,184264,136,76,60
336357,knw8089g,1558,212022,136,91,45
446308,kostek1213,1190,161926,136,81,55
66759,krzysiek61205,1281,174241,136,65,71
22560,ktototakgra,1594,216856,136,58,78
39593,kupienino1,1223,166339,136,51,85
82194,maczupipczu,1293,175938,136,90,46
25170,mattheq,1247,169676,136,76,60
24118,mcart,1125,153078,136,85,51
102343,mikolajwoj,1279,174067,136,70,66
59054,milkaa15,1275,173444,136,74,62
297395,mkp943g,1644,223653,136,78,58
176295,mon1212,1208,164295,136,80,56
390035,moreplayer01,1463,199016,136,88,48
350802,natalia1510,1271,172898,136,74,62
232127,nbn5687g,1465,199267,136,88,48
379153,nfd6510g,1289,175366,136,81,55
280232,ntw5440g,1203,163631,136,70,66
275226,offca,1465,199294,136,87,49
339903,offtza,1340,182372,136,115,21
18280,onassapalaa,1178,160320,136,48,88
577190,ptf2554g,1383,188199,136,61,75
207591,qba85,1286,175005,136,78,58
392280,ropienmozgu,1508,205221,136,76,60
553411,scaniar,1078,146652,136,47,89
53830,sm1999,1338,182079,136,79,57
19739,smichu,1198,162938,136,51,85
179437,sszynekk1,1333,181390,136,81,55
54510,staszeklevy,1462,198838,136,60,76
243221,swm5537g,1117,152006,136,56,80
343132,tpk1510g,1228,167139,136,70,66
438816,tpm3449g,1134,154355,136,50,86
92373,tulipanek9,1379,187559,136,109,27
12983,ufosuperdj,1721,234190,136,61,75
9414,vontifon,1423,193596,136,76,60
501476,wcd1685g,1237,168359,136,74,62
393794,wtd9210g,1253,170497,136,63,73
159410,wtf4458g,1233,167728,136,82,54
529036,wtn7294g,1210,164611,136,72,64
24501,yanek13,1230,167413,136,80,56
183504,0000mniejest,1422,192041,135,90,45
169020,12ewa34,1250,168786,135,68,67
14730,abartnik21,1283,173302,135,72,63
493100,bdg6708g,1279,172667,135,72,63
470492,bkw6885g,1174,158563,135,59,76
577392,bmt4625g,1251,168943,135,62,73
46868,bon6,1178,159136,135,51,84
448,boros,1474,199051,135,77,58
17054,bottoja,1350,182323,135,66,69
635078,cdp2051g,1428,192819,135,75,60
514110,czkawunia,1205,162751,135,48,87
149863,dpw7663g,1331,179789,135,98,37
341615,elyot1985,1393,188130,135,71,64
670481,fcd2367g,1357,183329,135,88,47
433728,ffc7226,1291,174325,135,81,54
401974,fiumek,1332,179911,135,61,74
216180,ftc4371g,1327,179268,135,80,55
588662,gdd1374g,1415,191057,135,89,46
53223,gks96,1294,174821,135,77,58
7553,grubym9,1388,187385,135,84,51
436189,gsw497g,1191,160896,135,42,93
12255,iback,1933,261035,135,59,76
347831,imi86,1247,168427,135,68,67
190680,jamjesmistrz,1353,182679,135,82,53
267372,justaa100,1334,180144,135,76,59
459333,kajo2002,1208,163102,135,85,50
195388,kamgod,1145,154610,135,50,85
49056,karkha,1218,164435,135,68,67
34451,karrr19,1268,171261,135,67,68
655684,kcd7640g,1298,175230,135,45,90
137976,lexuslfa,1546,208743,135,65,70
6614,lufek1,1598,215745,135,69,66
241941,madman210,1313,177315,135,67,68
56448,marcin4073,1243,167875,135,95,40
35609,mastektomia,1695,228884,135,77,58
287253,matisz10,1156,156187,135,51,84
2135,meeerow,1287,173842,135,67,68
650492,misiel88,1559,210557,135,86,49
231565,mlodychlopak1,1450,195755,135,67,68
602634,ngn4350g,1244,167975,135,75,60
476408,nkc8822g,1144,154442,135,42,93
206805,olibor,1142,154211,135,60,75
42274,ooooonaa,1182,159581,135,57,78
423857,palina97,1230,166163,135,60,75
504121,pilkarzykii,1174,158511,135,56,79
38082,pisiulinda,1486,200715,135,78,57
78734,pivvo,1306,176387,135,38,97
249528,plitwice,1378,186115,135,83,52
657153,pmf5699g,1312,177235,135,66,69
255526,r1adrian600,1541,208063,135,63,72
189520,rechot,1387,187377,135,109,26
420765,rodzinka4,1370,185078,135,81,54
154478,rysiekll,1367,184592,135,69,66
368031,rzeznikkur,1122,151543,135,49,86
568757,ssp360g,1233,166533,135,66,69
269090,tamerbream,1541,208038,135,67,68
193681,taurus31,1297,175119,135,77,58
232663,vulcan81,1470,198492,135,76,59
309343,wbp3570g,1314,177500,135,78,57
130657,wiktus22,1076,145343,135,40,95
98466,zakrent,1186,160217,135,55,80
607964,adrian137,1296,173792,134,98,36
524348,advvocat,1525,204467,134,74,60
516759,b00ski,1454,194902,134,80,54
68738,barden,1478,198163,134,84,50
310656,beataszydlo60,1228,164631,134,78,56
11484,bedzik15,1273,170591,134,82,52
16992,bledos87,1502,201328,134,89,45
230780,blueyesss,1186,158963,134,58,76
242455,bwt9274,1237,165846,134,62,72
420527,ceyas,1539,206262,134,80,54
219177,czypicosiem,1374,184220,134,78,56
70105,daszek12,1563,209464,134,97,37
129061,dluugi90,1092,146371,134,30,104
241531,elciap1981,1055,141406,134,24,110
44265,elgrucha,1266,169769,134,80,54
187558,elpaso91,1162,155827,134,53,81
120721,ewunia1010,1134,151961,134,40,94
476554,gkw9496g,1063,142472,134,31,103
276870,gmn9065g,1628,218271,134,118,16
46598,harnasw,1433,192052,134,80,54
222130,jackichan12,1513,202755,134,85,49
166321,jahew,1709,229080,134,86,48
213410,jaro3,1352,181242,134,106,28
117647,jkb18,1224,164140,134,71,63
647018,jnol,1225,164248,134,71,63
88001,johnzkoli,1560,209053,134,99,35
178381,jongenn,1414,189487,134,79,55
93903,kasia063,1192,159829,134,73,61
530024,kelemete,1187,159138,134,52,82
601853,kfn7714g,1206,161717,134,64,70
240088,kgp9164g,1256,168410,134,60,74
570042,knc7918g,1303,174693,134,60,74
4625,kubson5792,1243,166569,134,71,63
2312,lawnik,1236,165688,134,58,76
607965,lilianna95,1128,151256,134,36,98
429943,meloana,1287,172479,134,76,58
337940,mfk3784g,1293,173284,134,64,70
157631,mikolow,1293,173299,134,74,60
186039,misiu173,1252,167803,134,74,60
424734,monica2115,1376,184458,134,92,42
255408,mortiner,1337,179259,134,67,67
308425,mrs73,1499,200993,134,90,44
116073,murzyneczek1,1288,172665,134,83,51
478660,mwn2519g,1245,166927,134,51,83
16653,oo0marcin0oo,1338,179408,134,79,55
1114,pati359,1339,179530,134,76,58
332450,patryssiiaa,1237,165772,134,74,60
38344,paulokuchan,1338,179397,134,76,58
254713,psd4479g,1051,140929,134,27,107
70038,qnati,1169,156703,134,57,77
36580,quqi,1488,199487,134,76,58
38178,radykal,1614,216333,134,88,46
9435,rako2,1216,162982,134,46,88
227322,rat16v,1441,193114,134,64,70
355846,sananka1987,1443,193479,134,91,43
123019,skokvvbok,1407,188630,134,77,57
68827,slodkaasiulka,1605,215199,134,82,52
496046,sss2402g,1446,193764,134,74,60
213712,strefavip,1466,196519,134,96,38
46753,szatan358,1275,170896,134,83,51
657116,tff5798g,1218,163268,134,68,66
15880,tiaa,1217,163168,134,55,79
203898,tomek1293,1325,177594,134,80,54
599906,wdp959g,1221,163726,134,73,61
123806,128bit,1456,193716,133,75,58
71303,aniaoko,1272,169297,133,75,58
334384,antygen,1251,166447,133,61,72
552656,anwfvyavrwfml,1445,192316,133,133,0
7905,asiula8808,1247,165893,133,86,47
33729,asiunia80cz,965,128473,133,24,109
158281,b1tch216,1330,176896,133,64,69
51040,baggio0018,1228,163405,133,54,79
103011,bua78,1315,175012,133,75,58
7906,chgrey,1152,153307,133,47,86
550251,chinczyzna,1248,166045,133,83,50
555656,czarnuszka92,1288,171394,133,70,63
79730,cztery18,1312,174597,133,53,80
49688,czyja,1338,177955,133,67,66
221416,darensiol,1310,174268,133,88,45
357393,dcn3882g,1384,184185,133,90,43
552513,diagnosta93,1297,172534,133,67,66
481709,dkdk24,1446,192377,133,85,48
412269,dmd2208g,1215,161661,133,65,68
22129,edzia9998,1070,142363,133,46,87
155099,fanatyccy,1471,195706,133,70,63
163840,fbf334,1048,139405,133,22,111
580642,fct9717g,1308,174052,133,90,43
155350,fedor09,1331,177111,133,62,71
51366,fr3xix,1189,158230,133,60,73
346481,fsk4470g,1204,160149,133,67,66
154133,gff2744g,1524,202753,133,95,38
641661,ggn2658g,1183,157470,133,54,79
191900,gosienka01,1330,177009,133,75,58
225297,gracjanna123,1124,149554,133,63,70
16599,greton,1374,182848,133,76,57
378969,gsf8401,1291,171734,133,70,63
361,hakju,1461,194387,133,66,67
155327,jasamwdomu,1401,186337,133,65,68
2595,kitus55,1298,172669,133,62,71
29874,klaudiaosa,991,131892,133,18,115
69002,kocudzak111,1202,159886,133,60,73
330582,ksp2176g,1454,193438,133,94,39
90217,lata90te,1555,206833,133,89,44
240719,luxanna,1232,163887,133,52,81
23064,mattyx4,1098,146106,133,43,90
218863,mdd161,1195,159025,133,50,83
361489,mks3626g,1324,176216,133,66,67
163687,mroczneoblicz,1369,182173,133,81,52
665857,mtb2441g,1303,173329,133,76,57
38820,mucha789,1143,152138,133,54,79
73782,mysterious123,1268,168758,133,58,75
31439,natalkaa1111,1315,175003,133,94,39
22759,nexide,1418,188724,133,58,75
641020,npp2112,1227,163262,133,58,75
638697,nudysta,1250,166284,133,61,72
329874,pindolino,1301,173143,133,72,61
451440,polaryzacja,1478,196575,133,93,40
138273,polonez20,859,114277,133,19,114
186159,psg8244,1017,135334,133,27,106
522086,pss3548g,1285,170930,133,78,55
547381,ptf8114g,1178,156747,133,54,79
211251,qwert10,1131,150523,133,41,92
521116,skc6455g,1269,168864,133,61,72
501614,skubiekury,1365,181561,133,78,55
416768,szczypiorek27,1399,186152,133,83,50
264184,tak6ardz0ja,1152,153247,133,51,82
155677,tdg9123g,1301,173061,133,71,62
26611,tixoplast,1319,175451,133,66,67
578042,tpt5306g,1442,191798,133,80,53
431392,uniqq,1498,199346,133,77,56
104634,valentin30,1210,161058,133,66,67
10271,vamosbarca,1767,235124,133,83,50
73969,volframe,1990,264702,133,81,52
5881,waldemarsp8,1298,172648,133,60,73
291854,wks4871g,1136,151220,133,50,83
284238,wnb4060g,1026,136498,133,20,113
658219,woles79,1115,148427,133,38,95
102661,1850,1609,212413,132,89,43
40385,2zlo,1514,199892,132,83,49
19376,3vil,1486,196163,132,76,56
587153,ancurla3333,1234,163000,132,54,78
489185,aniolmandek,1061,140177,132,33,99
262750,arkadiusz21,1279,168921,132,70,62
462019,bbd1808g,1282,169313,132,66,66
344864,bbk5323g,1386,183031,132,55,77
351645,bgn2968g,1255,165776,132,63,69
207951,blondynka11,1246,164499,132,71,61
5610,budda1920,1205,159060,132,52,80
601965,cbs2525,1352,178573,132,74,58
14000,cebulakpolak,1265,167103,132,71,61
376802,cfm892g,1373,181303,132,86,46
357692,cgg222g,1233,162814,132,68,64
130486,dan7lol,1439,189962,132,102,30
508809,dekus1,1303,172091,132,69,63
450567,ducati,1525,201389,132,69,63
662645,egeszegeee,1257,165972,132,73,59
78671,ewelinaape,1360,179620,132,70,62
569624,fwb9760g,1159,153000,132,57,75
434196,gkw1181g,1366,180418,132,74,58
561487,gpny2807,1172,154710,132,67,65
391984,gramzkazym,1673,220923,132,100,32
61843,hubimistrz,1285,169735,132,72,60
190225,kacperrosss,1464,193331,132,84,48
36944,kakolewnica,1415,186889,132,82,50
322231,kalchem8,1505,198707,132,103,29
12215,kamil8566,1336,176372,132,78,54
438307,kcf7344g,1205,159070,132,57,75
363657,kdf3301g,1395,184222,132,78,54
71211,kersil19,1260,166360,132,73,59
37008,kinderr112,2050,270604,132,74,58
350353,kks1432g,1222,161305,132,85,47
306510,kmc3448g,1339,176876,132,95,37
39308,kochamkajke,2175,287183,132,81,51
638703,kolec86,1198,158187,132,42,90
129754,kryniu94,1208,159541,132,65,67
595757,lauferos,1474,194686,132,85,47
371288,loloco,1511,199499,132,74,58
21645,lud1wie,1202,158665,132,52,80
42763,lukas75th,1314,173469,132,55,77
135797,magneziwapn,1385,182951,132,73,59
96456,mmmmmmmmmm,1254,165649,132,62,70
54371,morenaap,1138,150252,132,55,77
1144,nietaktowny,1398,184609,132,65,67
647219,nori1987,1228,162114,132,65,67
60385,olgaaar,1308,172754,132,72,60
162687,oxlade,1419,187372,132,106,26
22531,pasi1399,1375,181617,132,80,52
549043,perfexim,1177,155384,132,63,69
11829,polish33,1109,146421,132,54,78
24586,pysia623,1311,173083,132,88,44
95336,rolelrcoster,1484,195965,132,79,53
283073,rumunwymiatacz,1315,173617,132,80,52
435257,samosia74,1306,172434,132,94,38
77063,sawionka,1109,146409,132,50,82
267627,snd944g,1454,191988,132,84,48
95858,stevie08,1230,162438,132,69,63
626305,swp1571g,1124,148392,132,44,88
187682,sztagan,1413,186562,132,62,70
10723,tajemnicza987,1225,161747,132,66,66
237054,tarna3,1229,162264,132,55,77
368188,tcw5921g,1342,177249,132,100,32
453900,tome4,1376,181734,132,93,39
286968,tpc1028g,1409,186024,132,105,27
83613,usz91,1202,158749,132,58,74
202766,wdd3349g,1375,181574,132,71,61
377713,woczajan,1345,177596,132,74,58
15830,zajedwabisty,1246,164538,132,66,66
615552,zawaternik,1355,178952,132,79,53
54186,zmiastajestem,1255,165675,132,55,77
3119,zukuiii,1312,173219,132,102,30
133165,zuraw007,1360,179577,132,69,63
275042,zybi0604,1120,147887,132,36,96
187855,adeeehade,1646,215755,131,77,54
64852,alicja199211,1174,153878,131,62,69
329423,arcusdesilva,1328,174027,131,100,31
368805,art3322,1539,201621,131,109,22
75787,asuj,1181,154778,131,56,75
70124,barbaczka,1453,190375,131,59,72
224542,blackhawkmb,1440,188694,131,71,60
316609,bns4839,1232,161454,131,62,69
230437,budzio02,1067,139864,131,33,98
399832,bukaj203,1343,175968,131,66,65
210342,carodziejd,1163,152463,131,47,84
362055,cgd1549g,1134,148660,131,55,76
593556,chwdp11,1228,160957,131,69,62
175500,damranking,914,119762,131,2,129
17371,daszaki,1327,173924,131,74,57
342703,dgp5594g,1394,182714,131,60,71
598886,dkb3879g,1092,143165,131,31,100
457581,dpb948g,1267,166068,131,67,64
43852,drobny1976,1235,161913,131,69,62
543556,dtd2496g,1273,166862,131,63,68
621723,dydek90,1294,169535,131,51,80
87420,esteraemma,1217,159492,131,60,71
141898,f4444,1436,188179,131,85,46
535801,gsk3469g,1242,162767,131,63,68
207092,hellogirls,1805,236528,131,66,65
258970,inaki,1376,180355,131,120,11
250489,jableczny11,1254,164347,131,64,67
36265,ji11j,1528,200296,131,78,53
140362,kacajka,1312,171980,131,70,61
6773,karinka5098,1267,165985,131,61,70
255304,komorrad,1206,158038,131,51,80
116559,kr21,1182,154869,131,59,72
387571,kroldawid,1503,196906,131,78,53
73353,kuk84hej,1293,169383,131,64,67
282788,kun6fub4nd4,1470,192634,131,56,75
371640,ladylady080,1378,180545,131,100,31
104330,lesetho,1259,164932,131,74,57
61581,luaszd,1286,168584,131,56,75
314101,martaa11,1381,181032,131,74,57
61365,maxihaxi123,1301,170488,131,65,66
60106,michal1805,1132,148379,131,48,83
1623,mily020,1444,189210,131,59,72
177820,miroslawcz,1301,170542,131,74,57
338534,msk953g,1140,149410,131,43,88
99477,n3onka,1368,179308,131,81,50
58737,nalaa513,1195,156553,131,56,75
143365,natalia0191,1151,150898,131,50,81
382747,ngb8739,1301,170452,131,83,48
243835,nocnyandrze,1129,147950,131,38,93
37551,odpadatomowy8,1129,147917,131,42,89
175711,orbital34,1286,168555,131,70,61
517669,puerta,1870,245012,131,76,55
25651,punisher050,1467,192183,131,115,16
9763,randalff,1251,163890,131,79,52
79853,sadi98,1142,149677,131,44,87
150153,sbg8790g,1282,167959,131,67,64
466385,sck9073,1120,146722,131,47,84
511898,shreko,1447,189625,131,77,54
36571,sonym2,1449,189820,131,71,60
158077,tabassco,1528,200250,131,67,64
395969,tarn0w,1370,179491,131,84,47
517667,tdw1478g,1320,172974,131,76,55
65241,topsik,1727,226294,131,106,25
16308,tyczka1,1214,159162,131,63,68
55877,tysia980,1164,152609,131,71,60
464796,wbp4041g,1298,170151,131,69,62
384872,wmc2737g,1303,170761,131,86,45
11240,wojnagtgt,1376,180378,131,82,49
53565,wojteker,1168,153060,131,57,74
121650,wpc3457,1217,159486,131,62,69
170403,19kokos,1196,155552,130,69,61
18034,3czaszki,1281,166592,130,79,51
114519,aga1612,1250,162528,130,58,72
557968,apokalipsa80,1375,178752,130,75,55
149460,asiek7900,1253,162965,130,60,70
167484,bastianswin,1373,178523,130,72,58
532936,bdt320,1199,155972,130,60,70
57046,bonustomistrz,1328,172685,130,74,56
40024,botojestfajne,2031,264032,130,83,47
46616,buszan,1251,162752,130,72,58
383299,ccw6847,1220,158655,130,68,62
566029,cwg1099g,1161,150971,130,62,68
2731,czaston,1873,243615,130,59,71
130189,dzoj,2330,303028,130,72,58
510302,fbm1609g,1528,198710,130,71,59
1811,flamiszczur,1121,145755,130,69,61
436390,fran10,1265,164467,130,64,66
290543,gmp6879g,1219,158521,130,65,65
315255,gpb2387g,1414,183851,130,84,46
597870,gringofrik,1420,184725,130,73,57
76078,hazzaaa,1266,164608,130,64,66
34338,jacksparrowback,1330,172997,130,69,61
50939,jj18,1290,167740,130,53,77
285039,kaliszaanka,1292,168021,130,63,67
491505,kapek13,1433,186415,130,70,60
583737,kck5032g,1534,199520,130,110,20
476470,kff1464g,1335,173596,130,77,53
2785,kleplem,1606,208834,130,88,42
464187,knm2441g,1221,158843,130,62,68
21069,kolpo12,1533,199383,130,101,29
235665,krakal,1087,141322,130,32,98
26430,kuriertv,1252,162817,130,75,55
168770,kwadrat28,1472,191451,130,69,61
93493,laania,1083,140881,130,73,57
191306,madziaz,1396,181564,130,78,52
303118,mariusz2302,1274,165664,130,71,59
372981,msd5024g,1189,154652,130,78,52
158094,n02,1667,216766,130,89,41
109219,nataluntek,1526,198429,130,83,47
560695,papersoccer,1489,193599,130,80,50
155783,patrycja2212,1112,144661,130,36,94
214061,paulaimichal,1386,180294,130,80,50
33044,pdn2861,1259,163689,130,74,56
23982,peterson18,1332,173241,130,63,67
388487,pilapila7,1192,155024,130,59,71
489540,piotrek91w,1368,177856,130,84,46
35931,pisior666,1508,196069,130,72,58
205116,quebonafide,1834,238537,130,119,11
182108,rankowskie,1549,201448,130,100,30
83075,renata09,1218,158420,130,69,61
135585,rozdupczator,1265,164529,130,60,70
121295,ruda88gdansk,1217,158336,130,69,61
534493,sahee,1272,165489,130,60,70
339718,scm8498g,1170,152224,130,52,78
9835,sculptor,1849,240387,130,70,60
607681,sdp1929g,1208,157040,130,66,64
3680,seku65,1178,153188,130,49,81
219297,smietnik,1384,180000,130,60,70
44257,sova2789,1208,157073,130,71,59
95666,st1gpl,1333,173299,130,65,65
64022,stivi85,1417,184281,130,78,52
4,sufu,1451,188728,130,112,18
389801,swf5764,1255,163194,130,66,64
190443,szengala,1620,210625,130,84,46
18137,tmrfwidzew,1727,224563,130,99,31
480419,tnc4928g,1186,154231,130,54,76
501421,tom790,1227,159522,130,59,71
130676,wiejskikoksu,1293,168167,130,70,60
217952,wwg3787g,1200,156057,130,55,75
526768,xpak0,1286,167229,130,73,57
157268,xxxtube,1364,177322,130,51,79
470426,yangmei,1160,150849,130,52,78
516869,ziomus29,1428,185722,130,73,57
648597,zioneogniem,1531,199078,130,76,54
260670,znalazlem4,1728,224659,130,104,26
115296,zonepredi,1913,248733,130,83,47
143034,10kolabrokerk,1225,158041,129,68,61
94630,1271z,1316,169788,129,61,68
614333,1989kamkub,1354,174687,129,73,56
34450,7nie1,1310,169020,129,66,63
12591,adik020,1282,165488,129,72,57
99652,aga12a12,1252,161580,129,68,61
85707,anunia36,1108,143025,129,58,71
4866,batorsky,1224,157921,129,65,64
314367,bbs3703g,1386,178865,129,73,56
295473,bck2163g,1351,174296,129,69,60
100157,beunoseaires,1403,181019,129,71,58
2844,bezmiar1444,1300,167734,129,73,56
599385,bfc555g,1300,167794,129,61,68
428572,bielaf,1760,227138,129,87,42
58862,borys2000,1783,230044,129,76,53
258255,bsd7041g,1286,165958,129,95,34
112110,bzcbzc,1411,182034,129,65,64
64680,chlopaklenki,1262,162862,129,58,71
603030,ddm3703g,1349,174117,129,67,62
459076,dkd2901g,1335,172237,129,77,52
256643,donieek,1213,156572,129,64,65
93904,doniou,1128,145524,129,49,80
329654,dpg4269g,1269,163784,129,60,69
234573,eeefbn,1413,182283,129,68,61
74968,evin0,1457,188015,129,83,46
438800,ffs5745g,1332,171926,129,88,41
462798,fgm1691g,1300,167711,129,74,55
656745,futtrader,1327,171191,129,66,63
106483,ggg5,1156,149145,129,43,86
410971,gks201g,1290,166428,129,72,57
123678,grubson212,1226,158168,129,59,70
652518,gtp4304g,1403,181089,129,79,50
203867,gwk944,1086,140155,129,34,95
10081,haczy,1288,166258,129,87,42
263571,hellomelon,1247,160885,129,77,52
653619,karol1997r,1401,180758,129,75,54
604873,kcs1827g,1483,191411,129,69,60
16768,konsper,1357,175135,129,88,41
1011,leptek,1516,195632,129,67,62
251089,lesnik93,1164,150168,129,53,76
452602,lukasek1916,1303,168140,129,69,60
121992,magenatpl,1169,150816,129,54,75
320711,malanowski,1426,184044,129,64,65
341217,mammuth,1335,172281,129,86,43
286522,marcin121289,1181,152389,129,65,64
15806,mariuszek9182,1623,209492,129,62,67
115704,martynahehehe,1257,162234,129,75,54
180458,matisiatkarz,1398,180469,129,81,48
24866,maxio2000,1007,130002,129,31,98
439672,meartyna,1203,155258,129,59,70
417228,mgk7887g,1175,151631,129,49,80
89431,michal0212,1235,159349,129,61,68
236369,nbp3096,1332,171851,129,81,48
93736,niegrzeczna28,1303,168159,129,75,54
338024,paputek99,1390,179426,129,104,25
33357,pawie0ko,1419,183058,129,74,55
391422,pietras2015,1218,157186,129,56,73
75902,polo9900,1205,155467,129,74,55
8602,radza1991,1223,157782,129,52,77
613629,scc6007g,1334,172101,129,77,52
173136,sdw6038g,1193,153956,129,51,78
572077,similes94,1155,149101,129,51,78
422019,stf4270g,1457,188046,129,76,53
387156,stronczysu,1503,193896,129,95,34
318742,stulistuli,1250,161371,129,56,73
110281,t3j,1203,155310,129,67,62
14207,tanijabol,1407,181534,129,73,56
296946,taraniks,1571,202764,129,99,30
15808,ththth,1340,172875,129,85,44
166092,totalnyupal,1402,180966,129,75,54
398267,tribute,1859,239851,129,110,19
553072,tsb5246g,1166,150495,129,53,76
633258,tsc5474g,1282,165385,129,59,70
28725,tutumi,1160,149761,129,49,80
346542,twojamala,1122,144866,129,35,94
346541,twojduzy,1277,164734,129,94,35
649751,ugumbumugumbu,1577,203551,129,75,54
16618,ulaz1,1528,197137,129,72,57
590016,umbalabombala,1343,173251,129,69,60
396998,vvhis,1437,185383,129,76,53
107258,wjustyna07,1064,137377,129,30,99
255073,wolny24h,1205,155557,129,52,77
22499,wracar,1232,158954,129,70,59
638743,xarslay108,1060,136849,129,33,96
105525,zdaszek,1616,208495,129,103,26
202384,15cc,1860,238084,128,67,61
5527,1982renata,1411,180657,128,60,68
16731,3zc,1442,184611,128,56,72
61283,abcdlmn,1143,146310,128,43,85
533819,akail,1565,200372,128,104,24
80270,angel3008,1102,141153,128,42,86
165270,apollo1234i,1197,153260,128,52,76
171161,arcymama,1401,179357,128,94,34
21401,arczinho,1356,173676,128,95,33
521123,b0unty,1441,184476,128,72,56
5555,baboczek123,1445,185056,128,73,55
334730,bnt9008g,1045,133777,128,26,102
263272,bomba7xd,1088,139387,128,57,71
143331,buteerax,1234,158012,128,75,53
344001,casillas95,1358,173929,128,72,56
315733,chabro5,1497,191632,128,85,43
273062,cnb7560g,1249,159997,128,76,52
514667,csc3550g,1191,152481,128,55,73
665227,dfg8495g,1195,153047,128,55,73
32079,drzewo2001,1164,149036,128,52,76
392181,fck8798g,1311,167882,128,86,42
568325,ffd614g,1164,149088,128,72,56
22329,gabroy,1206,154454,128,64,64
242640,gkn1639g,1203,154036,128,60,68
125089,graczkurnika1,1553,198870,128,104,24
480796,gtc6910g,1247,159711,128,82,46
143058,hec,1978,253273,128,85,43
13089,helmanss,1445,185031,128,53,75
92628,jakispawian,1313,168139,128,55,73
74447,jawka17,1205,154270,128,66,62
652317,jeremiasz12,1245,159485,128,67,61
333722,jubei,1329,170167,128,59,69
221736,jurekowsiak,1269,162457,128,72,56
50794,killbot,1377,176303,128,65,63
254250,kklaudia,1239,158641,128,58,70
358764,kpm4657,1281,164021,128,66,62
189561,ksn7557g,1196,153105,128,64,64
12044,kubaag1929,1241,158876,128,67,61
188790,m0re,1366,174908,128,54,74
165,majfa2,1429,182985,128,74,54
197699,mfd7908g,1143,146341,128,43,85
230342,mgd694,1126,144242,128,45,83
500862,mientutus,1401,179359,128,89,39
531956,misiaxdd,1169,149648,128,57,71
280854,misiek6969i,1242,159006,128,84,44
429522,mnw9498,1282,164120,128,53,75
400625,mojetooo,1498,191762,128,75,53
436793,mon1990,1103,141303,128,34,94
138592,mumekm,1138,145777,128,41,87
518023,natalia0716,1271,162734,128,68,60
79690,nauczciegrac,1441,184482,128,86,42
480797,ndg7456g,1152,147489,128,46,82
197698,ngb6749g,1256,160859,128,85,43
22811,niuniafajna,1484,189978,128,95,33
80567,pawcio25525,1258,161139,128,78,50
317369,polakoo14,1309,167647,128,92,36
564160,possdrou,1227,157083,128,44,84
116966,reksio20,1342,171898,128,95,33
46233,rych2,1200,153684,128,59,69
439433,rysio40,1309,167553,128,58,70
286521,sadgthsdefc,1271,162765,128,65,63
4852,schottkey,1549,198309,128,79,49
635399,sd30,1156,148032,128,50,78
237472,skg1235g,1249,159991,128,54,74
380252,stronczysa,1492,191092,128,92,36
290664,taraneks,1497,191741,128,98,30
2152,twojpromyk,1289,165092,128,69,59
47429,zabiccyganow,1344,172084,128,65,63
129353,zawszenakacu,1445,185004,128,62,66
567544,19maciej89,1406,178608,127,92,35
102462,2trepczan,1177,149548,127,56,71
415691,766,1516,192589,127,83,44
99677,alekkk98,1157,146945,127,50,77
298525,aniakamila,1266,160843,127,76,51
239513,arsenalwidmo,1514,192284,127,68,59
83726,bitmore,1278,162327,127,60,67
12927,blackpool,1123,142624,127,51,76
102796,bodudlam,1319,167558,127,53,74
589065,boss9,1546,196456,127,100,27
159345,bronekm6,1380,175295,127,65,62
22899,chrismmv,1266,160801,127,114,13
60815,dblu,1246,158304,127,60,67
197449,dmm8606g,1322,167950,127,68,59
128849,emkaes1973,1422,180714,127,83,44
374966,fdc9889g,1366,173530,127,60,67
584509,flooreks,1720,218549,127,99,28
204371,fnc9302g,1151,146272,127,54,73
297213,fuorigrotta,1337,169845,127,69,58
26944,gbc5364,1281,162775,127,71,56
174978,gkabaciktga,1234,156802,127,62,65
386954,gorniqzabrze,1487,188925,127,73,54
41014,greg0778,1124,142838,127,41,86
571584,gwn6467g,1385,176003,127,61,66
363477,ilovemyself,1302,165430,127,64,63
206816,kaktussek,1576,200216,127,96,31
5745,kamil51nd,1320,167754,127,70,57
12350,kamildob,1318,167487,127,85,42
113324,kamilw125,1214,154262,127,69,58
197866,karolina1,1449,184039,127,77,50
162341,kebes21,1348,171249,127,75,52
135637,killju,1227,155872,127,76,51
245880,klauducha96,1308,166146,127,73,54
219953,kogut88,1255,159417,127,76,51
102069,ksas,1640,208309,127,96,31
592914,kwt6266g,1088,138228,127,32,95
42845,loczoxd,1134,144136,127,47,80
88951,macio94,1243,157929,127,58,69
274814,malypiesek,1362,173072,127,76,51
88604,martinez456,1323,168114,127,82,45
104453,maslobezkislu,1420,180412,127,81,46
9223,masterbez,1276,162107,127,72,55
357,matiwisla,1328,168747,127,83,44
574379,matyspl,1252,159072,127,65,62
174616,mavkm,1702,216232,127,81,46
162833,mgt6173g,1092,138749,127,29,98
324574,mkc4278g,1256,159622,127,57,70
568403,mkt9475g,1086,137961,127,34,93
475984,mnk3633g,1099,139671,127,37,90
254455,mysick,1240,157536,127,76,51
289029,natasia992,1068,135755,127,45,82
240102,nieznajomy18,1458,185273,127,74,53
475808,npf5890g,1267,161002,127,57,70
649874,nps4961g,1296,164593,127,65,62
448796,nwt5355g,1383,175700,127,76,51
30453,patidedi1234,1227,155844,127,60,67
48146,pavers,1149,146031,127,61,66
653179,pdc1095g,1176,149406,127,24,103
471179,pkt5603g,1358,172472,127,66,61
160025,prkm1,1267,160947,127,66,61
100395,psychodriver,1321,167867,127,61,66
22066,pucik89,1273,161699,127,64,63
89344,scn8702g,1078,136952,127,32,95
119880,seksy7,1920,243884,127,68,59
45944,shevir,1333,169410,127,81,46
519055,skg9374g,1402,178155,127,88,39
42416,smolak0,1540,195611,127,84,43
74896,soulreaver92,1330,168926,127,78,49
70381,stingrey21,1309,166276,127,79,48
11417,stuli2,1288,163687,127,67,60
231950,takiekocie,1342,170529,127,79,48
481801,tygrys6,1217,154644,127,76,51
656555,urwis2111,1237,157110,127,49,78
8162,wari4t,1380,175296,127,65,62
393870,wcw260,1410,179079,127,65,62
656195,wdm4325g,1117,141941,127,35,92
20359,westpr0skater,1530,194355,127,69,58
654632,xyq11,1192,151443,127,60,67
31713,zabilemmisia,1355,172103,127,52,75
164465,000filips,1198,150988,126,53,73
568263,22rum,1356,170916,126,81,45
105626,adam642,1401,176537,126,103,23
238518,agaop,1375,173331,126,57,69
63069,aka8620,1282,161579,126,68,58
252828,annabiel1,1254,158055,126,69,57
194829,bart3kw,1174,147950,126,63,63
55420,bartekv12,1671,210612,126,123,3
456071,bnf6375g,1550,195417,126,67,59
383978,btf5437g,1264,159355,126,62,64
258586,burao,1620,204164,126,76,50
117868,damian1853,1154,145526,126,56,70
102749,daww1234,1025,129231,126,66,60
327816,ddf8017g,1217,153372,126,59,67
253272,dtn8023g,1339,168801,126,75,51
47018,f1racing,1392,175438,126,72,54
437249,fds1237g,1102,138891,126,30,96
519221,frytkii,1285,161980,126,73,53
328778,gothica96,1277,160993,126,85,41
17714,grabcia123,1224,154320,126,57,69
104504,grannyts,1415,178299,126,79,47
381927,gsp6457g,1108,139703,126,33,93
165487,gti,1230,155061,126,62,64
384037,gvgkpl,1233,155377,126,59,67
19712,intifada,1631,205542,126,47,79
333521,januszzaglady,1439,181361,126,76,50
329554,jestemciasna,1311,165249,126,67,59
184,justa1628,1404,176914,126,55,71
156607,kamil1112,1199,151163,126,60,66
410608,kamilola,1120,141148,126,56,70
99752,kanaronl,1370,172620,126,90,36
56155,kkn4201,1192,150276,126,59,67
176310,kopiepokostce,1286,162092,126,60,66
19107,kucharek95,1382,174168,126,72,54
61761,makaj997,1246,157036,126,97,29
3279,malcolm888,1438,181188,126,75,51
59095,maniek0401,1192,150264,126,57,69
4977,marcin0512,1258,158603,126,68,58
4023,marcino1508,1338,168641,126,74,52
2078,marian310,1304,164311,126,58,68
457897,mcf5139g,1314,165588,126,70,56
634150,mgc3769g,1198,151043,126,59,67
121977,minizord,2040,257160,126,74,52
622073,misiorex,1240,156309,126,54,72
298344,miszczu98,1164,146716,126,50,76
367030,mobydik,1401,176560,126,58,68
482326,mr100larz2,1146,144416,126,43,83
46063,n4t4l14,1475,185882,126,64,62
365455,nauszymniekto,1569,197734,126,82,44
348499,ngk1330g,1372,172884,126,72,54
640183,niegramjakcos,1421,179126,126,98,28
528428,niku4444,1211,152665,126,66,60
394734,npk3885g,1336,168452,126,62,64
142695,onanawalona,1369,172616,126,65,61
60060,opek1515,1303,164291,126,92,34
402650,orzel4444,1577,198706,126,97,29
46683,patryk3222,1122,141399,126,42,84
245923,pawcio24,1183,149082,126,67,59
355018,pawel1sw,1203,151666,126,70,56
121495,piotr96,1376,173377,126,74,52
371491,pkc9168g,1363,171844,126,67,59
642561,ptaszynka34,1303,164252,126,60,66
449701,ptn9378,1386,174727,126,73,53
383300,pwc171,1180,148708,126,56,70
37749,rfaaa,1362,171690,126,84,42
48824,scorpion1st,1239,156175,126,64,62
151801,sedre1212,1273,160491,126,70,56
52923,shelvik,1433,180611,126,77,49
62872,sinep,1158,145934,126,58,68
119277,skajtrak,1342,169186,126,65,61
248586,stw3923,1187,149654,126,53,73
98755,syphon33,1262,159025,126,62,64
248766,tnm6304g,1408,177431,126,86,40
80154,trajmi,1444,181992,126,85,41
429174,waniur,1265,159490,126,63,63
136,wapmad,1507,189966,126,57,69
266006,wazka95,1406,177262,126,105,21
587385,wdd2157g,1235,155625,126,56,70
343183,wsc3964g,1154,145467,126,54,72
493160,xxl32,1228,154834,126,72,54
345281,zbychstonoga,1436,181012,126,65,61
180368,zenekv6,1225,154387,126,76,50
47576,zimnasuka13,1262,159072,126,43,83
70702,adamjasadam,1771,221456,125,110,15
147741,bolgula,1495,186926,125,75,50
602572,bps3532g,1131,141497,125,44,81
651355,captjacksparrow,1252,156503,125,63,62
116939,cartmanland,1321,165177,125,77,48
445263,cbb9955g,1323,165434,125,68,57
217485,celnystrzall,1524,190599,125,82,43
93638,daspas,1664,208081,125,92,33
13437,dawidosiemosi,1495,186926,125,59,66
507169,dbw8693g,1301,162663,125,74,51
247671,ddk4721g,1364,170567,125,80,45
530772,dfw360g,1629,203709,125,93,32
577921,djadu,1357,169709,125,83,42
19231,dusia91,1267,158398,125,64,61
650703,dzik19,1159,144945,125,51,74
124563,ekstr2klasa,1550,193795,125,76,49
16412,emilejax3,1256,157054,125,73,52
493456,eurosreuro,1423,177908,125,79,46
55799,fbg8603g,1402,175351,125,72,53
282970,fbw7896g,1204,150517,125,60,65
144717,ggosiaczekk18,1245,155678,125,61,64
32261,globusgkm,1194,149287,125,47,78
444893,gns3931g,1474,184275,125,70,55
31354,guzike,1242,155364,125,48,77
148639,hinemann,1227,153439,125,61,64
304327,ig0rek,1703,212905,125,82,43
395695,intercitytrns,1225,153167,125,60,65
158995,jakubos1377ek,1283,160490,125,81,44
648367,joskinson,1102,137854,125,33,92
47508,ju19,1418,177360,125,70,55
127179,judo,1573,196640,125,89,36
297995,kapuch555443,1148,143606,125,52,73
62188,karolczi,1273,159185,125,81,44
12878,karolina51,1069,133636,125,36,89
651356,kdn8825,1249,156247,125,62,63
419352,kmc6523,1287,160931,125,89,36
404063,koddowiezien,1506,188344,125,93,32
359468,kowal83,1143,142895,125,52,73
577455,krooksu,1159,144963,125,45,80
524896,ksf440g,1370,171323,125,72,53
1342,lauretta1984,1270,158828,125,87,38
415717,magda1105,1200,150009,125,70,55
7700,marcinn782,1426,178309,125,77,48
273814,marijuanaaaa,1505,188224,125,64,61
148510,mars269,1368,171102,125,67,58
43485,mateush12p,1222,152750,125,58,67
91431,michal9104,1216,152093,125,57,68
98052,minimalnie,1395,174470,125,52,73
318021,mm7366,1458,182319,125,82,43
376947,mmd7011g,1301,162712,125,62,63
463299,mojedemony,1582,197786,125,81,44
397115,my3ego,1321,165149,125,57,68
459577,n4jl3pszy,1471,183963,125,66,59
38177,nessteti,1404,175508,125,68,57
540500,niczkaa,1212,151519,125,67,58
326442,omcur,1446,180807,125,75,50
127995,paulek123,1239,154986,125,80,45
606523,pep1985r,1258,157342,125,55,70
533639,pfd6540g,1273,159184,125,68,57
88837,piotrus1979,1269,158631,125,63,62
13315,plock19,1267,158450,125,76,49
133247,poziomhard1,1448,181020,125,76,49
281428,psn9607g,1285,160658,125,78,47
143412,rajan97,1149,143645,125,45,80
214980,rybarzowice,1123,140453,125,33,92
425993,saske,1690,211277,125,100,25
154240,seicam,1484,185616,125,87,38
533421,snp9272g,1230,153770,125,48,77
38097,sure9,1371,171439,125,81,44
140553,szalonywariat,1578,197338,125,87,38
57989,szarik95,1120,140030,125,45,80
448907,tahwanek,1198,149823,125,72,53
627743,tarnovv,1481,185174,125,101,24
555148,tck6533g,1122,140267,125,41,84
29806,tecik19,1393,174172,125,69,56
1433,tom9333,1474,184276,125,68,57
503445,tomas,1407,175890,125,88,37
149104,tomekk2001,1131,141390,125,43,82
7116,unikat97,1332,166617,125,66,59
44231,urokcygana2,1513,189236,125,76,49
101675,uszatekx,1283,160402,125,53,72
329424,vaastoja,1542,192765,125,96,29
31130,wielkipan,1464,183083,125,93,32
588619,wmpbardotka,1340,167564,125,88,37
6954,wrotekbelgia,1235,154402,125,52,73
559836,wsf3032g,1324,165556,125,74,51
153830,xeres54,1129,141249,125,40,85
321136,aaaaaf,1369,169815,124,61,63
14315,alerozkmin,1303,161605,124,73,51
28853,amrowaa,1337,165817,124,75,49
132,aneciaf,1104,136998,124,43,81
9402,anetaziolo2,1249,154998,124,67,57
79113,baqus2014,1152,142876,124,51,73
33339,basian86,1236,153353,124,71,53
50993,baymax,1371,170031,124,80,44
181705,blueturbo,1028,127503,124,16,108
404394,bpm154g,1161,143997,124,48,76
569812,bratower7325,1476,183038,124,83,41
462637,charlie90,1173,145463,124,44,80
284533,chmurkaleci,1331,165087,124,77,47
259529,chompchomp83,1205,149531,124,62,62
261326,cmn7068g,1380,171232,124,64,60
346035,csw3333g,1296,160737,124,58,66
603368,czarodzieej,1161,144059,124,53,71
100564,danie444,1183,146805,124,44,80
62248,daw1d,1384,171636,124,72,52
532259,djmafioza,1291,160160,124,86,38
545156,fcd4380g,1147,142303,124,44,80
55257,forest91,1547,191849,124,54,70
632736,gmofch,1385,171758,124,90,34
102887,gregmmvii,891,110560,124,4,120
270386,henryk2790,1202,149148,124,63,61
630530,honorvip,1179,146311,124,47,77
35842,ja1221,1162,144194,124,61,63
76838,jullien1,1188,147394,124,70,54
284700,kajakihamp,1227,152249,124,64,60
302860,kapral97,1391,172592,124,102,22
145914,karolum1994,1172,145369,124,45,79
64571,kckiniaa,1364,169219,124,75,49
181359,knp3651g,1324,164265,124,71,53
569318,kochamanie2,1210,150057,124,63,61
97631,kolton7,1292,160281,124,56,68
491165,kosma27,1338,165972,124,94,30
262328,larkone19,1240,153842,124,76,48
21735,lemurka555,1283,159210,124,63,61
760,lodowkawarki,1440,178609,124,75,49
145773,lolitaloli,1275,158185,124,73,51
419842,luk83,1228,152341,124,63,61
2169,lukasz170787,1256,155821,124,52,72
134290,malbroa,1292,160300,124,54,70
190279,manius15,1127,139856,124,39,85
464090,marakakas,1306,162059,124,85,39
90037,marius1975,1260,156286,124,63,61
517276,mbw6034g,1261,156428,124,64,60
73638,melleefresh,1721,213508,124,63,61
6769,mir90,1417,175767,124,54,70
527754,mlekozmamuta,1241,154006,124,76,48
185781,moczywur,1266,157106,124,62,62
22151,nataaalia,1443,178998,124,73,51
54125,nocnyszef,1314,163042,124,60,64
379793,nwf1611g,1188,147415,124,64,60
467137,pankott,1359,168552,124,74,50
13186,pawcio39,1279,158705,124,68,56
73908,pawel545,1286,159513,124,69,55
343544,pct5197g,1465,181738,124,72,52
167650,phunx,1470,182369,124,69,55
1116,pixastw,1427,177024,124,62,62
269443,plotkass,1560,193508,124,98,26
224745,rayanowsky,1294,160460,124,91,33
105065,ronaldoxd,1388,172166,124,67,57
107344,shlug,1212,150393,124,57,67
40490,shrek00,1349,167374,124,71,53
271001,snobi,1497,185665,124,72,52
143685,swm8791g,1166,144697,124,52,72
35341,szalonykeczup,1153,142989,124,47,77
401875,taren,1420,176180,124,82,42
365548,tbw9220g,1148,142455,124,46,78
203163,timorol,1184,146928,124,55,69
341045,tomasg,1425,176816,124,89,35
2479,tomek929,1228,152311,124,56,68
321358,tr3vch3r0us,1317,163317,124,99,25
214840,trhg,2285,283370,124,44,80
389781,wgd4480g,1351,167586,124,87,37
608916,wnm6941,1152,142923,124,50,74
28243,wszip,1329,164825,124,67,57
251966,wszystkojuz,1360,168724,124,98,26
1502,zajdek01,1201,149039,124,51,73
164637,zl0,1499,185891,124,89,35
615129,8731,1701,209255,123,98,25
131575,adams220,1195,147085,123,56,67
481920,alalisia11,1081,133055,123,39,84
243242,angelika321,1144,140748,123,38,85
401072,aniolek1324,1023,125872,123,23,100
256896,axl1,1212,149166,123,57,66
119614,aza1986,1516,186560,123,56,67
281725,bcw9282g,1309,161096,123,69,54
30495,benio11,1348,165918,123,61,62
524942,btd1740,1218,149900,123,71,52
434292,ckb4747g,1313,161543,123,69,54
193294,ckn3774g,1394,171492,123,68,55
463539,czuczu66,1066,131223,123,52,71
53405,damianeq26,1279,157354,123,62,61
28529,daniellst,1365,167956,123,85,38
614265,dawos116,1208,148615,123,59,64
557564,dds867g,1224,150560,123,59,64
69098,demonszosty,1736,213580,123,93,30
193297,dpb7589g,1379,169694,123,66,57
623514,gabe77,1179,145093,123,51,72
247888,galohart,1271,156358,123,59,64
6524,gazownik290,1328,163403,123,72,51
317875,ggw9988g,1175,144552,123,47,76
204258,gintori,1427,175633,123,82,41
116576,girlbrylancik,1232,151636,123,81,42
195604,goodplayerpl,1356,166896,123,85,38
634105,grudos14,1273,156653,123,62,61
113928,gumis600v,1173,144287,123,66,57
650495,jonnroberts,1271,156333,123,53,70
44222,justyska86,1260,155078,123,59,64
153677,kamco11,1160,142797,123,56,67
40408,kamilbiz,1270,156301,123,65,58
283823,kaszama12,1504,185072,123,86,37
343043,kfp1084g,1445,177855,123,78,45
108650,kingkaring,1328,163364,123,68,55
129187,kjndsj,1289,158591,123,60,63
62465,kornel777,1117,137393,123,61,62
122730,lafuriaroja,1336,164444,123,87,36
113836,maks2002,1218,149854,123,57,66
49697,marian941,1459,179505,123,78,45
330968,mati3211,1271,156426,123,85,38
1190,messiah,1449,178349,123,56,67
182786,miiikolajus,1386,170505,123,84,39
23820,mkrzysio11,1214,149344,123,48,75
475623,mmp2898g,1183,145587,123,54,69
541172,mpd2449g,1140,140220,123,50,73
288233,mwt5445g,1431,176053,123,55,68
35298,natalka6687,1291,158816,123,69,54
526826,ngp7195g,1379,169672,123,81,42
500456,niestaosienic,1294,159261,123,69,54
67640,npb1269,1106,136049,123,36,87
554392,nwg8615g,1635,201196,123,90,33
340611,nynu1234,1220,150152,123,66,57
21139,owiec1,1226,150884,123,39,84
574692,panwaski9919,1308,160924,123,75,48
472001,pawelki91,1611,198216,123,85,38
420493,pnf4936g,1387,170667,123,62,61
378319,porypany90,1381,169908,123,93,30
520424,przemek1208,1084,133389,123,34,89
585994,ptn6947g,1167,143651,123,54,69
583158,quwnowarte,1419,174586,123,78,45
8205,qxc123,1327,163235,123,54,69
621407,rafalb0,1278,157279,123,66,57
267463,redepep,1516,186550,123,69,54
105404,resbit,1259,154948,123,53,70
128163,richerthangod,1345,165470,123,54,69
389454,rozklimiewas,1192,146699,123,42,81
275552,saccid,1385,170475,123,64,59
92765,sztefinh,1175,144566,123,52,71
158351,tacopaco,1168,143699,123,59,64
348387,violl,1092,134342,123,37,86
233266,wdm7346g,1306,160665,123,73,50
42275,wzitt,1242,152791,123,68,55
8317,zebrantez,1290,158777,123,66,57
423694,znaszczynie,1228,151155,123,64,59
108267,zoidberg,1201,147726,123,48,75
502032,12szachy34,1186,144708,122,48,74
113014,2sty,1663,202894,122,72,50
551210,342,1371,167325,122,71,51
185249,aleksandra169,1157,141228,122,42,80
185528,anakonda9999,1155,141012,122,51,71
234603,artek1992,1217,148533,122,68,54
234013,balusm,1329,162154,122,65,57
106308,bbolec,1483,180935,122,73,49
379604,bks2429g,1152,140569,122,60,62
205935,bluelili,1519,185401,122,78,44
182213,bmm5163g,1256,153314,122,49,73
42066,bomba5,1580,192846,122,70,52
651220,bwc7728g,1379,168240,122,78,44
461677,c0ca,1700,207513,122,91,31
399668,calixpro,1190,145235,122,63,59
561843,cgm557g,1125,137254,122,55,67
510648,csm1246g,1277,155846,122,62,60
170301,denisxpompa,1436,175294,122,66,56
240459,doctoree0,1435,175073,122,73,49
299920,dominik1194,1217,148558,122,54,68
391436,dpt2353,1284,156689,122,72,50
576618,dwk8201g,1692,206535,122,95,27
72042,eripe,1825,222696,122,116,6
429959,ewelka10,1204,146928,122,42,80
624281,faflak,1270,155059,122,68,54
196424,farmeras,1111,135543,122,16,106
411218,fsb8520,1204,146990,122,52,70
511802,ftf4257g,1245,151963,122,68,54
326472,gcc7896g,1424,173757,122,73,49
342138,gdg4692g,1353,165170,122,89,33
604742,gfb8132g,1250,152562,122,65,57
610698,gnc688g,1450,176904,122,86,36
597446,gramzdurniem,1174,143266,122,62,60
339904,h1ghrise,1061,129522,122,18,104
304178,harcereczka6,1130,137877,122,48,74
122877,jamjesttomasz,1269,154899,122,79,43
168406,kala1988,1283,156598,122,60,62
277482,konsomolec,1424,173817,122,73,49
367914,ktw8609g,1180,143997,122,55,67
48365,kwiatek59,1302,158852,122,49,73
445767,left,1555,189766,122,82,40
169005,lejeklany,1522,185739,122,67,55
56748,liptooon,1485,181287,122,66,56
73169,lovcentki,1160,141582,122,60,62
563627,mafiapolska,1192,145489,122,43,79
83755,marcingdz91,1273,155424,122,78,44
214263,mariod,1123,137109,122,35,87
21496,mark2008r,1361,166096,122,70,52
382130,marlenson,1123,137123,122,44,78
19101,mateusz1436,1300,158609,122,51,71
384374,matmro1990,1330,162289,122,57,65
359724,mdc7149g,1409,171922,122,79,43
499013,megarobson,1190,145264,122,62,60
21366,mimur,1399,170754,122,103,19
14607,mksiak,1337,163217,122,62,60
537598,mwg6775g,1504,183603,122,85,37
480711,odmiennosc,2095,255591,122,80,42
953,pajlot22,1324,161559,122,77,45
30851,paju94,1281,156372,122,80,42
187644,pcs8299g,1250,152512,122,70,52
632910,pfb827g,1264,154324,122,54,68
227205,pitagorass1,1425,173929,122,90,32
377241,pms459g,1392,169884,122,70,52
462397,pwb4648g,1176,143477,122,43,79
36908,raterm,1379,168252,122,82,40
5220,sayaka1,1347,164438,122,58,64
121523,seebeeq,1125,137253,122,47,75
113943,soczek95,1155,140910,122,46,76
25430,szymon2202,1308,159642,122,65,57
582736,tamtuptam,1232,150345,122,74,48
341560,tomus1984,1299,158570,122,57,65
260606,tsf1028g,1196,145980,122,55,67
427569,tunay,1510,184327,122,74,48
128791,vegetariianka,1230,150098,122,76,46
232982,vinicius2016,1077,131505,122,13,109
80535,warkocz09,1098,134017,122,32,90
143035,wasek1,1209,147507,122,58,64
147584,wheelerdealer,1251,152659,122,80,42
39845,wigilijnyn,1691,206304,122,90,32
528937,wkg7277g,1114,135921,122,53,69
504536,wsn8909g,1236,150853,122,60,62
596713,wsw121g,1358,165762,122,32,90
87536,wtc9377,1458,177992,122,110,12
21402,adidasgd,1328,160777,121,56,65
271873,agatx,1135,137413,121,38,83
22510,ajabawiesie,1558,188587,121,58,63
69117,albatroaz,1228,148588,121,52,69
450680,andelott,1506,182257,121,80,41
80251,artexon,1404,169916,121,78,43
364126,asap0rocky,1500,181511,121,71,50
314478,cbm338g,1211,146567,121,54,67
399992,chawmupala,1218,147419,121,68,53
9130,cherryspokoj,1580,191284,121,109,12
279150,ckn7581g,1365,165172,121,63,58
235419,cpf7919g,1141,138078,121,48,73
61257,diablo316,1224,148182,121,57,64
489346,dpw7540g,1389,168091,121,78,43
330299,drugstar,1178,142546,121,58,63
3881,fakir100,1517,183586,121,70,51
325054,fbf8056g,1065,128933,121,34,87
20883,fighter2014,1294,156637,121,66,55
18261,figofago358,1391,168343,121,78,43
10182,filipek555,1304,157810,121,59,62
271809,fontanello,1246,150862,121,64,57
205861,ftt4838,1149,139059,121,46,75
387065,fwb146g,1239,149984,121,77,44
85956,geoffey,1649,199572,121,70,51
265570,ggd4884g,1381,167103,121,69,52
6576,ggnoob,1366,165367,121,71,50
116633,gkrystian99,1360,164657,121,70,51
160192,gtb2104,1259,152399,121,74,47
9522,hitman121,1270,153754,121,44,77
117646,jackooob,1198,145010,121,59,62
641683,jasinho94,1326,160554,121,75,46
204550,jestemtunowy1,2172,262911,121,56,65
219807,jumpik,1056,127844,121,28,93
345034,kalchem,1557,188407,121,102,19
3153,kingawar,1403,169828,121,75,46
328936,kochamnikolas,1231,148985,121,56,65
568153,kostek2509,1218,147432,121,53,68
628841,kpg5029g,1249,151141,121,63,58
240404,kubaczerwo,1348,163194,121,79,42
273108,levis1982,1274,154222,121,66,55
499136,lukoszu,1165,141043,121,49,72
530672,mateeusz,1482,179421,121,75,46
178777,matmat123,1382,167264,121,57,64
590111,mikus88,1155,139787,121,43,78
281360,moczull,1322,160020,121,72,49
311570,mrs66,1512,182973,121,75,46
37706,mufan1987,1410,170655,121,83,38
249843,myspit,1522,184261,121,100,21
574590,nasole,1218,147445,121,51,70
582612,npg8559g,1419,171794,121,76,45
8897,oliwkaneptun,1310,158550,121,113,8
42105,pabloaaa,1390,168268,121,57,64
503928,pajakk86,1319,159612,121,58,63
284020,pns706g,1230,148883,121,70,51
49696,polskirumun,1417,171497,121,59,62
1859,poncugm,1592,192686,121,54,67
10417,popocoyo,1564,189266,121,70,51
497829,ppb3038g,1402,169690,121,87,34
577383,przemekcz00,1188,143832,121,63,58
486684,przeworszczak,1256,152075,121,62,59
443868,quixiz0v,1183,143206,121,45,76
206256,rikki99,1017,123119,121,21,100
127965,rytuality,1392,168525,121,76,45
38598,sajmooon,1235,149489,121,74,47
81648,sandra5001,1122,135789,121,35,86
406413,sesebi,1219,147569,121,62,59
334489,silaczlowieka,1428,172807,121,72,49
289506,smakl,1687,204213,121,82,39
67763,stolarczyko,1107,134020,121,45,76
107196,szczun22,1455,176133,121,63,58
498230,tck6296g,1345,162828,121,67,54
140539,thekasia,1175,142260,121,58,63
92169,tiger96pl,1212,146728,121,62,59
6466,tritype,1442,174490,121,76,45
57900,vbot2,1453,175827,121,96,25
3684,victarion1,1541,186558,121,89,32
47263,wielu91,1438,174061,121,66,55
135224,wr0bell,1236,149628,121,52,69
234262,wuuuff,1366,165368,121,69,52
109202,zaglebiak1986,1319,159690,121,79,42
279439,10kw10,1412,169554,120,59,61
13979,25oni25,1263,151600,120,67,53
444,320d,2049,245916,120,80,40
57925,arturart,1266,151983,120,68,52
321775,ashbeck,1195,143509,120,44,76
287223,baku87,1111,133377,120,49,71
254010,biedr0na,1673,200869,120,70,50
196776,blebleebleee,1239,148784,120,62,58
317141,cpg5020g,1215,145863,120,59,61
636909,ctg9971g,1294,155316,120,60,60
621357,czekotubka,1117,134121,120,45,75
651130,d666h,1340,160914,120,73,47
228830,danielnorway,1378,165408,120,62,58
251231,dejwidp,1247,149745,120,55,65
546289,dkw5230g,1240,148803,120,43,77
175303,dmb9807g,1433,172054,120,75,45
272255,dpb1987,1121,134591,120,40,80
476686,dts6777g,1307,156860,120,57,63
442534,dzidzi90,1394,167301,120,71,49
655588,eviltvin,1678,201395,120,96,24
504685,fdf942,1145,137477,120,47,73
209569,fnd2085g,1512,181475,120,92,28
35839,gal1000,2049,245904,120,76,44
5566,gissmo28,1433,171968,120,71,49
1344,graszzkrolem,1439,172783,120,79,41
316613,grodd,1462,175495,120,60,60
298609,grzeso2,1407,168955,120,68,52
314648,gsf8138g,1297,155683,120,92,28
195138,gtd6779g,1347,161706,120,77,43
199103,gurnik69,1096,131634,120,36,84
316689,halaander,1150,138006,120,47,73
464126,horrorcore,1706,204819,120,99,21
517798,jankauskas,1719,206336,120,85,35
157463,jezollo,1427,171348,120,61,59
340451,justynkaaa,1229,147488,120,67,53
300299,kabanos02644,1109,133183,120,39,81
375,kamilkpn,1170,140460,120,38,82
288108,katarzyna87,1202,144279,120,41,79
608627,kcc1141g,1306,156783,120,65,55
227113,kgk8072,1380,165718,120,71,49
18393,klucha90,991,119017,120,20,100
338036,kms89,1306,156728,120,53,67
355414,kosiarz5,1229,147564,120,65,55
69378,lcz78,1281,153786,120,59,61
475978,lvlrado,1564,187708,120,81,39
562708,makalele1811,1267,152051,120,66,54
23796,mapet19,1021,122579,120,33,87
4250,marioboss1,1294,155375,120,54,66
318022,martonek,1483,178005,120,85,35
40163,medea1976,1570,188425,120,101,19
54330,mieru,1354,162569,120,73,47
311537,miszelplatini,1157,138882,120,42,78
146007,mlodyraz,1323,158761,120,73,47
31881,motomyszzmars,1453,174441,120,53,67
238325,mrrasta,1310,157210,120,77,43
352031,mysteriousboy,1377,165311,120,67,53
256150,ndp8273g,1353,162439,120,97,23
389275,nemrodgad,1507,180858,120,85,35
549708,nng1554g,1121,134628,120,31,89
345085,norbert1993,1187,142452,120,58,62
652171,numero10,1410,169250,120,51,69
110671,oyooyo,1237,148455,120,65,55
256108,p0ledance,1571,188530,120,89,31
63577,pantadeusz,1378,165450,120,72,48
5365,pawlak63,1239,148796,120,62,58
36391,pikachuu1,1214,145707,120,56,64
316638,png6390g,1302,156274,120,65,55
458956,przebije450,1162,139506,120,38,82
92040,przemekw33,1380,165713,120,85,35
220400,samotnyx,1377,165315,120,61,59
406718,sdw1586g,1276,153133,120,61,59
90354,sebaaaa090,1306,156754,120,74,46
120393,sether,1508,180973,120,79,41
758,sezonowiec,1727,207337,120,78,42
270770,skn2860g,1152,138294,120,58,62
7779,spicu,1213,145624,120,56,64
357989,szafagraibucz,1322,158700,120,81,39
144778,szkata,1284,154113,120,64,56
110298,t0m3k1,1288,154660,120,54,66
39897,tbtsiwy,1507,180948,120,73,47
585543,tds6025g,1139,136691,120,48,72
329612,tpk4032g,1222,146741,120,70,50
431968,tpn888g,1452,174249,120,65,55
518741,ttp6216g,1303,156407,120,57,63
57165,vbot1,1441,172956,120,94,26
52547,venomcrv,1459,175116,120,56,64
483196,wdb5625g,1251,150144,120,59,61
166371,whirpool,1508,181029,120,71,49
86960,wiecznyfor,1514,181749,120,84,36
165459,wojteks2009,1183,142063,120,61,59
148701,wsg1623g,1249,149979,120,61,59
180635,xdusiekx,1328,159467,120,55,65
597488,youmissme,1629,195507,120,91,29
246673,zaneta17,1188,142675,120,58,62
74975,0procenthot,1404,167120,119,59,60
13016,18norbus,1304,155225,119,53,66
684,333vend,1790,213111,119,77,42
425497,abracadabr,1546,184032,119,74,45
2372,adriano16,1448,172370,119,94,25
350289,agaburrr,1178,140224,119,51,68
135756,alucarrd,1252,148992,119,73,46
17212,babulajaga,1525,181526,119,74,45
135755,bardzolewymag,1175,139889,119,47,72
494413,bbb9147g,1350,160727,119,60,59
490455,bdw8198g,1300,154780,119,71,48
355512,bpd7176g,1076,128113,119,22,97
17865,chinczyk3453,1141,135862,119,35,84
13100,cini0,2126,253062,119,87,32
595710,codemasters,1650,196454,119,96,23
58340,dcj3829,1312,156167,119,59,60
296770,dcn348g,1310,155984,119,74,45
553783,dcn5195g,1416,168612,119,86,33
71099,devilbreath,1499,178470,119,76,43
655505,dnb3165g,1496,178119,119,79,40
104098,dokibyt,1367,162692,119,78,41
358695,dragonbolz,1507,179348,119,71,48
205755,emilka367,1119,133199,119,39,80
280231,fdw8099g,1192,141871,119,57,62
49730,furiorus01,1435,170868,119,79,40
355413,fwp4170g,1514,180207,119,94,25
585745,gar,1227,146119,119,50,69
74728,gg90,1204,143334,119,33,86
418490,ggt9010g,938,111655,119,3,116
486426,gmk9054g,1349,160610,119,72,47
277199,gnf9593g,1362,162182,119,83,36
477218,gwk7762g,1393,165884,119,63,56
241129,hddsa,1416,168573,119,68,51
216507,hepi93,1302,154971,119,62,57
7136,jaro08061988,1312,156145,119,65,54
65796,jayjayokocha2,1282,152599,119,56,63
134448,kamieel,1191,141738,119,51,68
463176,katayah,1155,137468,119,55,64
32511,kemezrpq,1119,133233,119,30,89
653178,kfp204g,1235,146988,119,54,65
377652,kidsdevourer,1363,162202,119,78,41
140760,krisuft,1339,159345,119,72,47
285925,ksi3zyc,1639,195072,119,72,47
659368,ktg7854g,1204,143369,119,47,72
83510,lemon1993,1179,140402,119,49,70
354044,lkonradl,1293,153961,119,49,70
19268,lutek90,1290,153549,119,68,51
3965,malina5678,1225,145867,119,65,54
68986,malwina95,1200,142888,119,36,83
235757,marc32,1327,157976,119,61,58
216836,masakratorowy,1502,178805,119,78,41
453695,mateusz633,1208,143864,119,51,68
9668,matrungniez,1417,168632,119,67,52
3985,michalllooo81,1407,167539,119,60,59
78262,misiek8931,1294,154022,119,75,44
100782,mruczek1997,1128,134277,119,41,78
353537,msb4645g,1293,153873,119,60,59
303385,msr73,1535,182719,119,83,36
1399,nadopach,1413,168164,119,70,49
410744,nairov,1243,147937,119,52,67
321194,nbc4262g,1165,138662,119,52,67
163519,nfm7923,1156,137666,119,48,71
268203,ot0czka,1679,199868,119,82,37
638320,pbp9832g,1302,154994,119,56,63
398463,pdp7947g,1011,120416,119,21,98
51920,peachgirl,1526,181617,119,53,66
3388,pgf1,1287,153176,119,66,53
571418,pieknazaneta,1580,188080,119,90,29
3530,plona8,1305,155327,119,74,45
317628,porkster,1192,141882,119,52,67
75925,qazze,1360,161865,119,75,44
248547,rakuene,1206,143619,119,61,58
214347,rosikjunior,1314,156458,119,94,25
340629,rycerzjaroty,1499,178460,119,76,43
34051,sabato23,1242,147893,119,62,57
446886,scn7573g,1403,166980,119,110,9
395910,skf6215g,1084,129114,119,37,82
543628,slabaosoba,1424,169493,119,73,46
48310,ssony,1475,175572,119,75,44
451346,stachoo90,1170,139274,119,44,75
411769,swm4491g,1431,170373,119,73,46
264008,tatarocek,1195,142292,119,55,64
655976,tft6228g,1334,158814,119,71,48
7756,thedoorss,1454,173048,119,67,52
340698,tnf6896g,1188,141434,119,51,68
198976,tomaj91,1283,152686,119,65,54
70566,tomii87,1511,179857,119,70,49
278053,ttsline,1649,196257,119,84,35
103982,umiemgrac9,1376,163841,119,67,52
381369,uouoo,1472,175229,119,70,49
111583,vector88,1195,142310,119,50,69
406843,veqaa,1293,153910,119,53,66
146848,wkg9725g,1351,160847,119,53,66
113822,wonskikacper,1199,142793,119,59,60
291195,wsc2968g,1215,144592,119,61,58
323,wydupcona,1345,160102,119,58,61
163049,zimel85,1266,150658,119,51,68
268,61procent,1515,178853,118,73,45
92511,75rob7,1301,153518,118,74,44
66612,adziula7,1293,152601,118,69,49
233633,agatasas04,1199,141596,118,54,64
578731,agusssia1234,1282,151279,118,67,51
121497,ajcilopp,1284,151519,118,58,60
389968,amerykan3,1373,162082,118,101,17
230904,an5555,1107,130626,118,38,80
61807,argon,1457,171976,118,76,42
2149,arkadio7,1363,160856,118,53,65
359668,balotelli,1357,160230,118,65,53
167140,bbn1144g,1271,150000,118,60,58
209195,bct542g,1279,151037,118,58,60
399056,bdg7133g,1201,141809,118,49,69
389411,bfw2273g,1097,129481,118,41,77
275285,bkrl,1327,156688,118,70,48
16850,blau10grana,1533,180962,118,52,66
393739,blondasiewicz,1276,150580,118,71,47
4399,bodzio753,1302,153750,118,64,54
208612,borysmax,1209,142739,118,49,69
571140,btp6968g,1030,121597,118,24,94
149925,cfm729g,1251,147730,118,50,68
479510,cms2802g,1219,143952,118,61,57
374935,crystains,1242,146575,118,74,44
633169,ctp8084g,1340,158232,118,60,58
85857,daniel222,1209,142729,118,40,78
12054,dawidc2,1042,123069,118,25,93
312507,dfd5932g,1348,159122,118,83,35
404268,dtf5278g,1259,148610,118,60,58
566670,dtn1020,1330,157051,118,74,44
131852,elizeusz,1316,155365,118,56,62
340934,ernins,1311,154760,118,61,57
320249,ewq321,1353,159665,118,50,68
226350,fasola,1040,122721,118,41,77
20194,fasolka88,1210,142820,118,58,60
204232,ffredzio,1210,142803,118,57,61
338432,fms3798g,1232,145445,118,59,59
148799,get1,1470,173488,118,68,50
399860,gmara89,1296,152995,118,61,57
152587,goniewka,1494,176316,118,82,36
68890,h5h5,1323,156135,118,82,36
62540,haaawk,1350,159319,118,79,39
360327,holek99,1209,142742,118,47,71
42946,kajka101,1215,143454,118,50,68
477705,kamax,1198,141382,118,48,70
452011,karolek17,1312,154909,118,51,67
78979,kasiazbysia,1179,139181,118,42,76
645019,kbt6105g,1323,156156,118,69,49
3968,kfs1979,1278,150921,118,62,56
269958,kingapy,1165,137508,118,49,69
629509,kns6069g,1522,179617,118,75,43
169296,kryspin84,1197,141275,118,34,84
292773,kubk324,1187,140114,118,51,67
12941,lock69,1254,147998,118,59,59
247486,macsku,1238,146200,118,46,72
35541,mala95,1194,140971,118,46,72
347330,malutka10,1308,154347,118,68,50
36831,marcinn600,1252,147738,118,63,55
59558,marciochaw,1151,135854,118,51,67
54998,marinesoldier,1546,182473,118,38,80
361937,matrol2006,1295,152896,118,55,63
17293,misiek97,1313,154954,118,70,48
56815,mistrzyni12m,1437,169678,118,73,45
525052,nbb3558g,1144,135094,118,46,72
231288,nortron,1327,156626,118,84,34
645176,ntg8528g,1040,122731,118,23,95
174804,nwf9251g,1149,135585,118,42,76
211855,operator92,1311,154706,118,62,56
160290,p0kemon,1581,186587,118,71,47
150400,paolo94,1239,146207,118,50,68
310275,pawelk10,1340,158231,118,80,38
438,piotreeeeeek,1259,148570,118,53,65
59287,qveo,1305,154018,118,77,41
34132,sandra2oo1,1167,137794,118,44,74
213178,scb5184g,1130,133431,118,45,73
614457,sfs2185g,1220,144023,118,59,59
374960,skm7728g,1147,135387,118,46,72
207495,skuvrwiel,1449,171064,118,74,44
107635,slaba25,1230,145206,118,55,63
197283,swiecaartur,1248,147363,118,72,46
1098,szaliczek,1279,150974,118,51,67
308184,tcd3722g,1386,163564,118,77,41
415167,tkk5144g,1196,141130,118,47,71
2972,tomeqk,1292,152570,118,75,43
31530,virrq,1252,147842,118,63,55
102246,warcabowy,1047,123605,118,20,98
274764,wwb3106g,1315,155282,118,62,56
380712,wwn3188,1095,129304,118,42,76
91002,xxlopuchaxx,1141,134736,118,19,99
408046,yayaa,1371,161828,118,51,67
37937,zagrajzemna09,1088,128428,118,38,80
103801,zimonk9,1031,121693,118,28,90
96004,17nanana08,1310,153298,117,77,40
189,6thking,1668,195225,117,83,34
249040,ac5dc,1425,166735,117,75,42
67504,aga9agnes,1178,137935,117,65,52
37530,al0jzy,1448,169420,117,52,65
169754,aniaheheh,1346,157489,117,72,45
87769,anikah,1262,147765,117,63,54
302657,antyganja,1618,189357,117,73,44
326047,bdm1315g,1472,172303,117,75,42
500711,bdm7666,1180,138074,117,48,69
476288,bfs5727g,1218,142585,117,59,58
551150,bgn1458g,1254,146785,117,68,49
527006,bmc1898g,1112,130206,117,38,79
269719,bnf5444g,1309,153254,117,69,48
456723,caribe,1519,177738,117,83,34
53729,damianek17,1345,157385,117,66,51
85174,darcoo,1271,148715,117,67,50
17047,dudek2901,1416,165675,117,77,40
82588,dytka7,1163,136116,117,44,73
425533,ebelo,1274,149098,117,62,55
12633,elucha91,1362,159454,117,53,64
263263,extra0rdinary,1407,164634,117,71,46
387066,fdw7799g,1168,136707,117,47,70
625133,fkc5193g,1243,145531,117,44,73
587836,formalesa,1392,162963,117,69,48
105731,fybyny666,1404,164364,117,58,59
519586,gdm6956g,1206,141188,117,64,53
581367,gwp3783g,1234,144382,117,73,44
56212,haszczu18,1302,152374,117,78,39
64157,homixx,1327,155305,117,69,48
228894,hubertfon,1235,144532,117,69,48
237954,ifool,1636,191509,117,72,45
41814,jareczex,1326,155163,117,55,62
41245,je6ik,1280,149843,117,64,53
166268,jo13,1325,155089,117,63,54
184992,kaczbet,1236,144630,117,46,71
512770,karlikowa,1336,156313,117,66,51
256689,kbw3794g,1287,150679,117,57,60
207611,ken69,1224,143323,117,70,47
150813,kinkirinki,1387,162393,117,63,54
593881,koniunkcja,1597,186899,117,94,23
14942,kosmateq,1140,133462,117,26,91
100563,kynio2,1344,157276,117,55,62
88466,loloxpompa,1147,134286,117,35,82
386981,lukrecjakr,1126,131851,117,48,69
390529,maerleena,1201,140581,117,52,65
80202,malymen11,1393,163060,117,71,46
464635,miropl1,1307,152978,117,88,29
54038,mistrzzapisy,1768,206936,117,63,54
124001,monika113,1258,147266,117,54,63
91001,mozer4,1539,180086,117,107,10
68806,nick0dlajaj,1940,227045,117,59,58
72004,niringe,988,115682,117,15,102
36790,nr1proxon,1504,176061,117,90,27
172676,nunu94,1173,137326,117,44,73
47620,on14ck,1416,165760,117,84,33
652787,orzech229,1103,129059,117,30,87
7133,pabllo23,1360,159226,117,59,58
551930,pff586g,1392,162970,117,53,64
640515,pgb9920g,1318,154254,117,68,49
33255,pilkasrilka,1338,156657,117,53,64
326642,pla4a,1501,175732,117,76,41
629860,popko,1198,140262,117,58,59
537845,potwor,1740,203642,117,102,15
390135,ppb7948g,1355,158548,117,72,45
100261,promilsl,1808,211555,117,56,61
649885,psb438g,1441,168692,117,81,36
244183,psg6935g,1199,140323,117,49,68
7291,rafal792,1264,147990,117,67,50
140489,regeman,1204,140887,117,69,48
188882,rroch,1256,147009,117,66,51
299151,scd5472g,1420,166182,117,69,48
313848,sgd9636g,1324,154963,117,74,43
182035,siwucha135,1334,156165,117,58,59
48667,skati05,1641,192093,117,60,57
206289,skros,1332,155915,117,67,50
96973,slodkiewicz333,2234,261474,117,69,48
251844,szczawiuuu,1334,156094,117,81,36
195036,talkin2myself,1555,181958,117,83,34
634467,thomas34,1468,171819,117,96,21
6082,tomekk1k,1419,166063,117,65,52
597610,twix,1773,207479,117,108,9
45834,warchlakinho,1353,158313,117,63,54
42897,whitepowernig,1177,137778,117,63,54
33257,zaff94,1320,154488,117,70,47
124866,zounkey,1338,156622,117,85,32
4134,080206,1608,186627,116,75,41
670796,0u0,1653,191757,116,88,28
33837,1zuko,1344,155998,116,56,60
552148,364,1292,149935,116,50,66
297907,3k0m1ny,1447,167862,116,91,25
571,acmilan108,1375,159602,116,46,70
64333,aizdam2323,1134,131622,116,41,75
420461,amorek10,929,107865,116,6,110
31226,anyzarg,1572,182366,116,70,46
192559,athaniel1927,1304,151284,116,65,51
86803,avepigma,978,113458,116,17,99
4727,badisu,1277,148210,116,65,51
614968,bar0n,1476,171299,116,61,55
204351,bartez86,1187,137719,116,46,70
200665,beben80,1309,151867,116,86,30
93083,blackfury,1390,161267,116,98,18
8570,bmg9285,1260,146208,116,77,39
87301,bonzai4,1178,136747,116,58,58
72324,bulik90,1198,139079,116,49,67
636265,cbk7551g,1451,168348,116,74,42
610022,ccn4358g,1705,197797,116,102,14
608671,ciahopostrah,1162,134826,116,45,71
62999,cobretta,1522,176554,116,54,62
248039,dlcron,1355,157265,116,64,52
51261,dvmi,1418,164599,116,79,37
562300,fbc2541g,1368,158800,116,72,44
425477,fearless000,1112,129079,116,33,83
616096,fifekpl,1339,155370,116,95,21
656823,fwc1858g,1151,133538,116,44,72
326877,gfb6123g,1272,147571,116,69,47
62668,grafol,1405,163035,116,61,55
382659,healek10,1282,148762,116,77,39
315864,httpdiv,1440,167150,116,84,32
4605,issaa85,1324,153610,116,85,31
89573,izabela2005a,967,112184,116,9,107
44600,jakub1335,1362,158059,116,68,48
129785,jasio001,1218,141389,116,47,69
1280,jot3,1444,167578,116,76,40
506665,kamyczek86,1184,137417,116,55,61
79250,karinapozn,1549,179745,116,88,28
225376,kasia1119,1241,144008,116,58,58
149410,kochamkasie,1162,134878,116,47,69
149280,kopaakabana,1458,169196,116,65,51
151405,kov104,1209,140322,116,53,63
484957,kubulak99,1115,129381,116,41,75
415512,kwiatuszekdla,1217,141233,116,62,54
46644,lenobia,1225,142179,116,61,55
3885,lester85,1239,143792,116,58,58
96149,lila454,1328,154162,116,60,56
534441,lippi,1681,195038,116,85,31
7885,lukas96,1394,161791,116,71,45
11040,lwowo,1342,155769,116,66,50
343276,maartures95,1352,156881,116,64,52
242687,maly2o,1235,143373,116,47,69
29706,marleniaq,1260,146266,116,54,62
89846,miissiieek,1258,145946,116,49,67
34283,minio229,1212,140671,116,63,53
603916,mirok78r,1264,146659,116,67,49
402428,misiaczek77,1308,151769,116,74,42
57002,mister1x1,1545,179239,116,100,16
366347,mmt8822g,1198,139024,116,51,65
10580,mojeooko,1223,141882,116,58,58
219463,mrpit91,1401,162519,116,66,50
100510,murkyangel,1587,184185,116,64,52
143259,mynameis,1229,142569,116,43,73
97473,nikolenka7,998,115883,116,15,101
336948,nineinched,1151,133559,116,37,79
323610,noao,1706,197922,116,82,34
438359,patrykbks96,1089,126412,116,22,94
412405,pim,1199,139175,116,49,67
573636,pmn3295g,1489,172761,116,88,28
180313,przeszczep12,1078,125153,116,39,77
476900,r1066,1456,168927,116,72,44
54935,ruggel,1588,184259,116,69,47
604277,rumci,1291,149770,116,66,50
155608,sdc6743g,1299,150769,116,63,53
323850,seekiros,1255,145589,116,68,48
298513,snb2682g,1208,140201,116,55,61
79668,spoczynek,1227,142349,116,71,45
69168,techprogaming,1203,139661,116,74,42
48414,thebu,1782,206825,116,59,57
233884,tkp6758g,1423,165173,116,76,40
337385,ujuhcyt,1353,156964,116,76,40
185982,wawrosr,1304,151318,116,65,51
651806,wgn6984g,1475,171117,116,104,12
201972,whinberry,1189,138020,116,45,71
250637,wiktor34,1284,149031,116,62,54
580195,wkt2100g,1162,134880,116,45,71
440060,wsg753g,1421,164939,116,66,50
76819,zubrzubr,1214,140893,116,56,60
559021,12o,1473,169486,115,86,29
1118,adarem666,1255,144337,115,65,50
145933,aldek13,1529,175888,115,80,35
936,awap,1454,167229,115,84,31
134562,b0b,1595,183462,115,68,47
188866,bcn2602g,1118,128575,115,38,77
131428,bestialuqen,1974,227073,115,82,33
139415,bubuss6,1283,147584,115,60,55
28842,cbf393,1130,129975,115,35,80
9974,celwojtek,1233,141828,115,53,62
287965,cfn6187g,1303,149933,115,59,56
56161,cgk2807,1193,137309,115,58,57
159336,chieef,1420,163330,115,63,52
532795,ckf8885g,1219,140262,115,52,63
590958,dann1002,1282,147430,115,67,48
173072,ddw9848g,1150,132319,115,43,72
2200,delmowaty,1112,127974,115,44,71
108316,dfd1060g,1275,146679,115,66,49
7001,djandreas87,1343,154507,115,67,48
233217,dobridobri,1145,131744,115,32,83
284019,dsw3589g,1177,135360,115,48,67
404545,dzordzykus,1170,134594,115,45,70
389373,ekstrakasa,1485,170839,115,69,46
52535,falki85,1360,156508,115,87,28
484085,fmf1880g,1345,154702,115,77,38
482109,fnt4603g,1079,124156,115,35,80
167096,friix,1173,134946,115,49,66
78732,gabigabgabi,1104,127026,115,28,87
352617,gepans,1391,160016,115,99,16
294965,gkt5333g,1347,155013,115,71,44
527174,gnk7007g,1179,135693,115,45,70
129416,hacker24pl,1385,159345,115,59,56
616197,hejkej123,1373,157947,115,71,44
342266,hendryg,1463,168351,115,57,58
542863,jaitytyija,1276,146787,115,68,47
121993,jakub10nowak,1221,140467,115,65,50
446965,kahaelo,1158,133211,115,53,62
38517,kak00vicio,1269,146007,115,62,53
175959,kara029,1363,156803,115,69,46
653990,kct7464g,1286,147943,115,65,50
548426,kdf3247,1688,194123,115,88,27
304305,kinga9999,1259,144828,115,78,37
242918,krystexx,1239,142509,115,48,67
246440,kwm1936g,1110,127663,115,30,85
87364,lolkowy26,1041,119736,115,28,87
30622,lukidom,1496,172105,115,79,36
5412,madzialenna89,1247,143423,115,55,60
142004,mania015,1164,133882,115,62,53
507044,mariobross365,1241,142720,115,60,55
76381,mbs9797g,1165,134068,115,33,82
111526,mehowek,1284,147753,115,92,23
463607,monita15,1152,132526,115,40,75
251946,mrbartek,1306,150236,115,75,40
96055,mrmgr,1274,146567,115,63,52
28975,muccio,1243,143031,115,58,57
296417,mutsy,1318,151593,115,66,49
284027,nexteeromi,1277,146855,115,74,41
409550,nwb5554,1173,134933,115,50,65
102180,olkoprorok,1313,151095,115,66,49
530563,ourxenie,1243,143035,115,58,57
273406,pkm1071g,1313,151043,115,78,37
213700,pogromcasetik,1458,167684,115,76,39
478449,ppf4847g,1401,161131,115,67,48
620981,ptm2026g,1247,143437,115,72,43
484700,ptw3265g,1326,152571,115,60,55
104635,radunic,1204,138483,115,56,59
562913,reme13,1166,134143,115,43,72
394165,ryhor,1191,137062,115,50,65
539276,sanawaifu,1390,159944,115,63,52
597095,sdk3687g,1251,143873,115,59,56
35085,stacha03,1008,115965,115,42,73
553130,sukurukukum25,1450,166776,115,78,37
350288,szmulo18,1242,142893,115,68,47
151663,tan104,1255,144387,115,64,51
237854,tcc4987g,1150,132325,115,45,70
595805,tmf9227g,1048,120632,115,17,98
11485,tomas6781,1179,135678,115,50,65
399364,turekjest,1397,160693,115,82,33
187676,twalcott,1305,150178,115,69,46
1446,uep,1609,185138,115,49,66
487644,visus19,1228,141299,115,45,70
361420,wcn7787g,1300,149608,115,54,61
509065,welpawel77,1206,138786,115,60,55
222057,worldoftanks,1485,170798,115,52,63
226597,xandir1,1418,163170,115,64,51
129540,zzikeer,1544,177655,115,69,46
409312,0qwertyy,1460,166468,114,73,41
109401,0rigamik,1442,164494,114,73,41
178971,21popolnocy,1439,164070,114,64,50
111522,7rippy,1673,190733,114,90,24
610612,aczi32,1295,147735,114,67,47
2060,agnieszka2005,1417,161613,114,61,53
154715,alechin1,1372,156413,114,56,58
389449,asdfghjklplpl,1052,120041,114,21,93
11144,bartektyl,1221,139275,114,48,66
510292,bnw8776g,1116,127286,114,35,79
126426,bnzo,1628,185684,114,68,46
319710,bomberman3,1279,145913,114,65,49
36728,bulas24,1391,158687,114,68,46
409548,cgp6124,1213,138282,114,59,55
160191,ckt4879,1191,135852,114,49,65
179,damian0493,1307,149032,114,47,67
1598,damiansdl,1330,151680,114,61,53
123700,darkwarm,1421,162057,114,57,57
269915,dawid364,1238,141216,114,59,55
207413,dejw1989,1350,153900,114,69,45
16124,depczatur,1175,134052,114,55,59
326762,desperadose19,1296,147802,114,62,52
561471,dgt2806g,1278,145741,114,61,53
483544,dmn6737g,1259,143577,114,65,49
186842,dominator69,1593,181661,114,84,30
362551,dsc5460g,1294,147545,114,64,50
51923,dyniowy,1312,149581,114,86,28
99657,dyniowy3,1378,157199,114,63,51
240805,fabiaan,1500,171006,114,81,33
461039,fks5273g,1380,157361,114,67,47
16473,geniek64,1744,198822,114,51,63
255542,ggm7467g,1215,138529,114,47,67
349229,gpb3960g,1150,131150,114,40,74
86067,herkuless7,1164,132783,114,44,70
635694,hermiona1,1309,149288,114,86,28
382308,is7,1556,177434,114,92,22
552118,iwona1994,1257,143341,114,79,35
256662,jakamashi,1330,151683,114,52,62
96222,jakubeknt,1077,122874,114,31,83
126977,janko89barca,1255,143166,114,58,56
109572,judegang1,1251,142632,114,51,63
186439,kaczor1234,1272,145092,114,58,56
456705,kiedysbylo,1759,200534,114,104,10
631672,klaudiaa0192,1075,122660,114,40,74
260613,konradoow86,1330,151718,114,56,58
176381,krolowapls,1219,139022,114,57,57
158737,ktn8017g,1292,147339,114,67,47
330283,lih,1484,169289,114,65,49
12259,malpa034,1339,152650,114,60,54
462538,mmagdaa89,1276,145494,114,71,43
449998,mpg6735g,1362,155364,114,71,43
653640,mpp6363g,1209,137852,114,44,70
2493,mrok2008,1320,150544,114,50,64
302204,ncs5576g,1093,124646,114,34,80
333680,niuniusia15,1086,123854,114,28,86
623588,nks1972g,1474,168055,114,59,55
620002,nkw8869g,1225,139658,114,59,55
5045,ovenhpr,1302,148508,114,60,54
362852,pgg8394,1185,135148,114,58,56
404263,posadzkarz,1332,151900,114,59,55
128884,posejdon66,1263,144079,114,42,72
405963,qbakuba,1454,165864,114,73,41
619929,regres,1694,193228,114,86,28
374974,sbp5536g,1163,132612,114,41,73
19946,seniu661,1369,156173,114,100,14
44512,sereczekk,1293,147404,114,60,54
419569,siwy1004,1206,137487,114,63,51
333498,snw1786g,1660,189342,114,88,26
175919,tfk774,1231,140344,114,56,58
264550,tfs3223g,1335,152209,114,61,53
568966,thesokolowka,1479,168682,114,65,49
413781,vampir99,1454,165815,114,60,54
179991,wbf6122g,1519,173251,114,81,33
589941,wcb8107g,1518,173159,114,70,44
97231,wciaaa,1229,140145,114,49,65
578379,wwd839g,1406,160367,114,80,34
343469,wydymomen,1430,163112,114,62,52
234665,xyz2016z,1204,137351,114,57,57
651710,yezus,1366,155780,114,78,36
13130,0headhunterz,1778,200930,113,76,37
115662,1i9z9k8a,1268,143317,113,61,52
215,5555,1325,149734,113,55,58
573979,adamgrabar,1358,153546,113,77,36
11253,adriank55,1218,137738,113,37,76
306504,adzia44,1207,136470,113,53,60
35252,airlinelot,1952,220595,113,73,40
120197,ajazkrol,1864,210722,113,53,60
219105,ala10,1234,139461,113,73,40
608999,albercik0701,1222,138096,113,53,60
67039,andrzej88c,1310,148065,113,66,47
286982,anqa1,1175,132862,113,55,58
75700,anule3ka96,1229,138983,113,56,57
172640,baramanasana,1611,182150,113,79,34
26325,betti44,1242,140401,113,92,21
582795,bieniaaas,1442,162988,113,103,10
486912,bkg4139g,1313,148419,113,65,48
360973,bsb1855g,1198,135461,113,50,63
154014,bum1cyk,1482,167494,113,76,37
104723,byctamgdziety,1389,157016,113,52,61
14508,cocking,1242,140437,113,60,53
7642,dajziemniaki,1223,138285,113,44,69
43636,davvca0rgazmu,1613,182311,113,67,46
9304,dembele,1551,175359,113,50,63
325673,dodusia22,1255,141872,113,65,48
71280,domek20,1387,156794,113,67,46
322919,dwc9699g,1216,137486,113,54,59
35807,dysney,1465,165569,113,56,57
46383,fadi10,1401,158321,113,75,38
107267,fein,1397,157969,113,67,46
204320,ffw2693,1223,138265,113,67,46
437203,filus09,1261,142503,113,75,38
101543,fraierici,1317,148920,113,75,38
97757,grzela93,1170,132266,113,45,68
496783,gws7133g,1171,132425,113,45,68
44405,hansus16,1444,163201,113,68,45
342688,iceventre,1229,138912,113,67,46
123188,jasiowie,1204,136092,113,47,66
235594,jonvs21,1378,155715,113,70,43
497,jtk8681g,1356,153293,113,58,55
18592,kns8124,1191,134670,113,60,53
193313,korwinkrul199,1283,145070,113,61,52
483273,kowbojczacza,1259,142337,113,48,65
118222,krecioch,1119,126526,113,35,78
51291,krysti1996,1309,147968,113,66,47
573284,kryysiaa,1445,163331,113,72,41
103960,leszczyk1,1286,145388,113,62,51
13476,liebert,1211,136897,113,53,60
229384,lionelmessi2,1311,148188,113,57,56
37137,lkkiersztan,1380,155995,113,71,42
13392,lolololo3,1234,139547,113,53,60
412901,lukasz207,1190,134568,113,52,61
206657,lukaszbor,1116,126131,113,43,70
94040,lvlikilvl,1806,204121,113,87,26
20634,maciek420,1160,131182,113,33,80
2138,maczo87,1431,161733,113,63,50
33487,mai5ter,1122,126806,113,32,81
40462,mariuszwx201,1369,154715,113,64,49
101784,matik600,1156,130658,113,44,69
304204,mimimilka,1366,154423,113,91,22
578161,miropln1,1174,132662,113,46,67
333364,mkf210g,1289,145722,113,78,35
603528,mpg8102g,1171,132408,113,47,66
565001,nkc3417,1151,130135,113,41,72
378594,ntf5335g,1354,153007,113,78,35
579562,o0000o,1442,162971,113,70,43
550904,otello7,1581,178762,113,90,23
641117,pantusjan,1250,141275,113,87,26
217186,pawello232,1171,132384,113,46,67
398335,piotr12,1514,171189,113,84,29
37699,pnb1172,1138,128667,113,41,72
27097,polarisaqua,1250,141361,113,68,45
33582,police89,1204,136052,113,43,70
320726,pom24,1468,165886,113,81,32
224037,przemo1908,1246,140803,113,70,43
335220,pst318g,1108,125261,113,42,71
497215,ptk6975g,1349,152471,113,70,43
517511,rafal77rafal,1169,132129,113,33,80
41446,rgregregreg,1391,157206,113,64,49
282134,rouss96,1277,144308,113,66,47
412858,sfm772g,1607,181630,113,78,35
442071,sgd9939g,1375,155391,113,78,35
193248,skylake,1468,165921,113,72,41
177756,sorlands,1331,150431,113,52,61
113162,spodkiecy12,1287,145475,113,53,60
28329,stonka299,1182,133605,113,51,62
393050,survivorman,1389,157062,113,64,49
254563,swf6180g,1263,142723,113,61,52
597980,tbp9967g,1311,148219,113,67,46
190000,tedeusz89,1277,144313,113,51,62
127942,traszczka,1497,169257,113,78,35
110783,trilleshvt,1317,148873,113,61,52
464716,tymeek,1423,160810,113,97,16
482632,ubie,1666,188325,113,78,35
54756,wigilia2,1629,184118,113,76,37
354050,windowsme,1540,174058,113,63,50
423150,wnb2909g,1151,130089,113,41,72
95157,yumikoo,1218,137663,113,62,51
82844,zeciol,1248,141104,113,56,57
36643,12dda,1270,142248,112,60,52
550126,302,1282,143593,112,54,58
21722,9totylkogra4,1189,133263,112,45,67
1228,adiskr,1316,147395,112,59,53
30218,aga6k,1262,141442,112,54,58
107429,aliamerehb,1055,118270,112,22,90
88665,amant,1423,159455,112,69,43
608016,amelkaka,1213,135961,112,55,57
22923,asdasdq,1446,161978,112,69,43
648366,bajbi,1315,147383,112,91,21
389825,bct8614g,1326,148519,112,63,49
608534,bejker,1194,133816,112,55,57
124996,blackfacepl,1249,139951,112,66,46
98921,btp334,1120,125534,112,39,73
13050,bultras20,1271,142448,112,39,73
132211,bws3108,1320,147874,112,71,41
655913,cgm3568g,1435,160803,112,78,34
111527,chooohe,1064,119275,112,21,91
572592,dds4960g,1175,131671,112,46,66
168011,dgb7801g,1213,135875,112,50,62
232917,drekonox,1391,155802,112,61,51
266134,dzierzak,1180,132268,112,47,65
451173,dzinia2222,1128,126428,112,33,79
270706,edison1,1263,141539,112,63,49
180421,elooelaa,1253,140336,112,62,50
307895,fgd1824g,1372,153716,112,71,41
1834,filiphawk,1413,158354,112,78,34
28489,fracek555,1278,143137,112,43,69
7850,franek876,1215,136121,112,48,64
445998,ftf2375g,1286,144141,112,71,41
14547,gaucho94,1439,161197,112,56,56
143847,gecon,1077,120651,112,17,95
235366,grabarz9026,1344,150598,112,69,43
447827,halomoto,1250,140097,112,54,58
382712,hatteras,1309,146712,112,60,52
15440,hempy92,1274,142699,112,46,66
153116,hisokaaa,1292,144735,112,59,53
457128,hugokopterek1,1734,194317,112,89,23
399685,janekgame,1143,128073,112,49,63
68904,jondeep,1318,147662,112,53,59
40010,kamillloos,1581,177084,112,62,50
1328,karollo8434,1329,148906,112,44,68
639398,knn1416g,1300,145611,112,55,57
487952,kpc1416g,1640,183781,112,85,27
186363,kpn6263g,1243,139249,112,61,51
16043,kromal71,1137,127351,112,32,80
68017,kubaszl122,1277,143084,112,77,35
114508,kumto,1178,131995,112,34,78
441100,l4wolne,1395,156253,112,70,42
57255,lech8,1271,142425,112,52,60
2259,lolcia012,1201,134512,112,54,58
102055,lotar08,1299,145497,112,61,51
446087,madzialenkowa,1260,141215,112,69,43
301794,marcinkoper,1222,136937,112,56,56
562889,marcinsea,1287,144186,112,60,52
44930,martaa91,1491,166998,112,74,38
419629,martynnnkkka,1220,136678,112,53,59
186962,mdp1247g,1117,125158,112,31,81
664001,mfs2110g,1100,123237,112,22,90
294753,mikrucik,1229,137731,112,54,58
378217,monika3991,1192,133587,112,57,55
219954,musliowocowe,1195,133886,112,52,60
294472,mwm5393g,1150,128823,112,42,70
490768,nabzdyngolony,1170,131056,112,48,64
154370,najto22,1216,136270,112,50,62
133590,navigator97,1069,119781,112,27,85
333843,necro,1065,119383,112,25,87
596021,neo131,1192,133534,112,53,59
60842,niedowiarek93,1220,136649,112,61,51
510256,nsc7553g,1126,126196,112,28,84
404628,nsk9334g,1072,120173,112,26,86
524597,ntk4238,1168,130927,112,43,69
396740,ntn12,1181,132278,112,40,72
523948,od0dobohatera,1671,187243,112,87,25
38831,olezmc,1479,165684,112,66,46
127318,p0zdro,1416,158684,112,68,44
90991,panspinacz,1388,155506,112,63,49
205754,pawelek2402,1253,140350,112,72,40
62505,piotra5,1008,112980,112,12,100
597820,pitrr,1168,130830,112,48,64
378281,pojechany,1486,166433,112,63,49
163498,pokobi,1303,145959,112,53,59
265807,polaryton,1455,162961,112,66,46
376925,pralka2894,1251,140199,112,54,58
416929,psitek,1700,190503,112,79,33
607255,pws7538g,1296,145177,112,57,55
632249,queenka4,1154,129307,112,39,73
357943,radekkotek,1110,124349,112,48,64
2297,rajakicia,1251,140182,112,63,49
41631,salynecka,1445,161911,112,93,19
260340,szybkobramka,1252,140301,112,57,55
384204,tcc7028g,1425,159638,112,69,43
115894,tiruriruble,1169,130960,112,51,61
493462,tnb5429g,1080,120983,112,27,85
117603,trolkurnika,1360,152385,112,78,34
186839,tsn6182g,1505,168598,112,85,27
87290,tubthumping,1773,198610,112,33,79
645562,wns1508g,1376,154213,112,56,56
587933,wojciech45,1233,138179,112,65,47
38819,wojteeek010,1210,135541,112,57,55
176711,wsw3905g,1220,136662,112,56,56
30043,zabiore,1468,164453,112,66,46
273326,zuzia3915,1110,124351,112,33,79
566213,0lo,1557,172936,111,58,53
580362,19kaziu77,1314,145940,111,73,38
112836,4x4na4,1507,167285,111,63,48
28821,amino5,1355,150444,111,67,44
42030,arcziwawa,1533,170206,111,83,28
68549,aylin7,1082,120192,111,31,80
126563,balcer098,1114,123733,111,33,78
399740,bartekh82,1225,136021,111,49,62
542759,bcaa,1500,166526,111,64,47
126663,beautifulll,1262,140167,111,68,43
476457,bgp3247g,1322,146753,111,60,51
636382,bieliik,1179,130875,111,42,69
1058,bilmanro,1267,140651,111,48,63
236481,bravoty93,1398,155225,111,57,54
641465,brawomistrzu,1499,166493,111,79,32
30067,breakitdown,1583,175719,111,87,24
575493,cbf9115g,1297,143999,111,64,47
237806,ciociadzwoni,1211,134515,111,44,67
25416,crazygirl123,1213,134667,111,50,61
222505,csmsah,984,109333,111,19,92
58035,cycuszek1,1255,139345,111,54,57
91068,dafiii,1057,117378,111,26,85
175603,damaszek,1371,152243,111,60,51
27966,daminpyrasz,1062,117973,111,43,68
14220,dollar83,1318,146382,111,51,60
219065,doominatoor,1442,160108,111,64,47
339712,dorothe7,1214,134836,111,56,55
364892,dragston,1539,170934,111,90,21
261398,dziubekw24,1180,130998,111,38,73
90310,f17,1235,137089,111,56,55
391641,fmm2057,1268,140763,111,47,64
155237,ftri1,1407,156237,111,64,47
91573,fuleroo,1368,151945,111,69,42
296951,gcd6580g,1220,135455,111,51,60
274731,gcg2974g,1289,143083,111,52,59
570420,gnd9906g,1351,149979,111,79,32
50832,grzegim1,1361,151165,111,58,53
168272,grzegrzolka,1109,123155,111,18,93
621356,gucio5,1182,131297,111,65,46
116415,hastersik,1516,168293,111,75,36
21908,jaqni,1427,158399,111,58,53
534715,jareczek83,1252,139061,111,51,60
38026,joniczan,1329,147615,111,70,41
277828,kak0mat321,1322,146821,111,40,71
235148,karolek7890,1180,131080,111,52,59
432595,kdt4036g,1353,150195,111,63,48
440824,keny0601,1245,138230,111,64,47
10894,kksns,1405,155958,111,70,41
224897,kkw5193,1153,128020,111,45,66
149409,kochaamemila,1213,134673,111,64,47
118821,korniczek15,1316,146145,111,80,31
119060,lidiankaa,1331,147811,111,68,43
52087,lvlasujdzika,1629,180858,111,69,42
64837,lvliklo,1853,205708,111,70,41
403816,maesstroo,1240,137710,111,61,50
102786,marcopoloo,1460,162148,111,54,57
150596,mariacziiiii,1349,149754,111,71,40
119727,maryjuusz,1383,153530,111,82,29
151143,michu336,916,101700,111,15,96
66351,michukng,1495,166054,111,78,33
80924,mirelka17,1128,125209,111,37,74
496782,mkk3359g,1230,136592,111,67,44
308019,mkt9739g,1127,125127,111,35,76
337113,mst5144g,1313,145835,111,66,45
460650,muszka8198,1202,133429,111,50,61
19896,natalciahihi,1154,128125,111,47,64
468291,nfc5491g,1356,150544,111,69,42
116884,nightlovell,1523,169117,111,71,40
239207,nnt7546g,1268,140801,111,61,50
377373,npm2495g,1144,127071,111,37,74
222008,oczy80,1219,135349,111,55,56
122139,ogrywamwpana,1273,141400,111,46,65
106906,ojtamojtamoj3,1639,181979,111,81,30
57296,olol93,1399,155337,111,49,62
143651,otegapala,1291,143349,111,58,53
140694,pawel2123,1282,142336,111,59,52
24891,pawelbaggio83,1339,148721,111,66,45
640331,pdw9590g,1286,142778,111,55,56
185294,pijebyzyc,1908,211812,111,69,42
251512,pmt343g,1389,154271,111,85,26
43170,polishpsycho,1339,148668,111,65,46
537120,pps7746g,1243,138024,111,53,58
155538,psychicall,1330,147715,111,81,30
121033,restanek,1531,169952,111,82,29
22681,rifiki,1060,117760,111,26,85
83322,ruchawicaaa,1325,147131,111,45,66
51639,sarusia097,990,109966,111,26,85
103386,scs298g,1217,135193,111,52,59
120406,simchazi,1460,162128,111,67,44
9064,skowron1,1258,139720,111,54,57
483703,t0men,1399,155289,111,70,41
299434,tcn7706,1383,153516,111,65,46
143332,thereisit,1128,125258,111,41,70
32415,twojaastara,1495,165997,111,61,50
54791,tymmek,1556,172823,111,66,45
167756,waldy666,1214,134807,111,50,61
75617,weniz,1160,128782,111,37,74
29801,wera3009,1180,131085,111,47,64
465420,whenyou,1658,184107,111,84,27
199854,xupong,1422,157857,111,64,47
215877,yebst,1418,157506,111,69,42
268652,zdzislaw8209,1366,151642,111,68,43
569937,0bbi,1629,179224,110,69,41
133211,0cnie,1305,143623,110,59,51
24515,0jamielnik0,1550,170558,110,52,58
169882,77tywo,1353,148910,110,59,51
87774,adasio2005r,1451,159701,110,81,29
522858,adrian103,1420,156237,110,61,49
165717,akikooo,1088,119718,110,26,84
631736,ang2008,1082,119052,110,26,84
38017,b4nann,1383,152235,110,53,57
636933,barton1,1347,148232,110,59,51
66152,belikebj,1367,150474,110,51,59
1043,bezczlonek,1404,154524,110,52,58
145906,bigmarianek,1047,115241,110,12,98
12559,biloj,1264,139121,110,48,62
522947,bombus96,1194,131389,110,36,74
395059,cabagge,1220,134227,110,62,48
444983,cfn960g,1409,155033,110,96,14
85437,dag777,1189,130849,110,50,60
452379,dbk3264g,1345,147954,110,66,44
56874,dcf6695,1270,139734,110,66,44
216407,dfc2631g,1303,143388,110,59,51
644704,dudawielki,1472,161968,110,60,50
9900,dzidek16,1329,146285,110,56,54
104195,elite0fking,2232,245593,110,73,37
40978,elune,1461,160721,110,56,54
56804,ewelina17,1325,145762,110,60,50
649236,fdt8085g,1159,127564,110,48,62
8303,feithfull,1195,131516,110,60,50
482371,ffp8184g,1185,130426,110,44,66
241397,fgd1340g,1139,125384,110,31,79
22484,gdanskibks,1276,140407,110,65,45
653629,gkm4361g,1094,120401,110,31,79
171726,gosia4999,1118,123060,110,46,64
520411,gpm7899g,1210,133146,110,61,49
300654,gpt6299g,1297,142703,110,78,32
494689,gregbydg,1296,142570,110,64,46
16329,grubson1111,1141,125615,110,48,62
649186,gwb4170g,1347,148213,110,73,37
641937,gwn923,1214,133556,110,58,52
17357,hadeas,1546,170061,110,64,46
483289,jambrose777,1057,116298,110,29,81
45385,justgoatbaby,1446,159150,110,57,53
44927,kacha1234b,1498,164804,110,73,37
51486,kalasnjikov,1630,179379,110,54,56
353958,kingajz,1524,167656,110,89,21
293668,kmw4516,1327,146076,110,74,36
115904,kriss17,1190,130943,110,61,49
603230,krisusu,1421,156415,110,70,40
47499,krystian81x,1265,139222,110,55,55
209959,kup1234,1105,121569,110,41,69
29141,kusik23,1134,124792,110,48,62
395060,leniwabula,1179,129773,110,48,62
365385,luki325,1099,120921,110,33,77
643853,maciaszczyk,1193,131238,110,51,59
140990,malutkijohny,1314,144586,110,55,55
273645,mateuszw,1410,155166,110,61,49
151,matt2mad,1412,155334,110,55,55
214823,miauczmnie,1455,160082,110,74,36
437204,misia1715,1130,124381,110,35,75
463538,mistrzkogamy,1030,113316,110,38,72
14675,miszcz111,1203,132382,110,48,62
130458,mnw6130,1185,130356,110,47,63
52635,monnyxxl,1180,129853,110,54,56
207758,morrafreak,1167,128478,110,41,69
18431,nemoge,1471,161901,110,56,54
236465,nsd8920g,1150,126519,110,40,70
21131,palemcia,1190,130947,110,60,50
10467,pawlonek24a,1173,129134,110,48,62
139412,pcn636g,1384,152330,110,63,47
535712,pdn2563g,1240,136429,110,54,56
66488,platonok,978,107655,110,7,103
269743,qbackyy,1279,140763,110,58,52
229647,rav89j,1218,134074,110,48,62
477023,rotschild,1207,132794,110,53,57
92867,sclx,1355,149126,110,60,50
504966,sdjhfbgdjkflk,1137,125097,110,37,73
4449,shumishumi,1343,147815,110,50,60
17318,sofi156,1337,147085,110,59,51
569825,spider1123,1361,149780,110,66,44
2474,szuwarekrts,1297,142761,110,52,58
24405,tomasmarzaek,1363,149993,110,67,43
197216,tomoj5pom,1596,175615,110,72,38
148158,urbi202,1357,149340,110,62,48
13671,usiu255,1317,144969,110,62,48
190964,wet3ran,1654,181948,110,79,31
46568,wwp8256,1218,134062,110,51,59
581916,xxsobek1xx,1311,144240,110,67,43
3276,xxvvjojo,1242,136668,110,47,63
88935,zoom90,1296,142627,110,42,68
314269,19dareczek48,1298,141546,109,54,55
28637,87santana,1307,142538,109,57,52
245570,agaggaga,1310,142841,109,42,67
4121,akimboslice,1681,183318,109,64,45
111582,aneciak8,1228,133918,109,58,51
199440,apo34,1214,132408,109,47,62
443679,b0tgra,1679,183097,109,70,39
114697,balzak,1164,126958,109,26,83
55047,bartek957,1210,131893,109,59,50
642461,bbg779g,1280,139600,109,78,31
523687,bmc7185g,1420,154880,109,78,31
350610,bubbleass,1399,152519,109,73,36
103646,buzia891,1221,133117,109,52,57
398321,byde,1668,181832,109,70,39
20249,corkizenka,1426,155440,109,65,44
372892,daria9719,1295,141193,109,67,42
503875,dfd6472g,1241,135339,109,67,42
641040,dff174g,1228,133876,109,49,60
596670,dgb8506g,1171,127672,109,59,50
41247,edycia1988,1367,149054,109,72,37
368509,ever81,1070,116711,109,25,84
200829,fanzi,1279,139433,109,55,54
326471,fgs6906g,1252,136544,109,57,52
503471,fifencja,1319,143830,109,63,46
328172,fred5n,1074,117137,109,30,79
424503,freefrag13,1190,129775,109,39,70
574145,fss4402g,1229,134069,109,46,63
494831,gbm1633g,1441,157145,109,68,41
14862,gracjan17,1374,149776,109,84,25
629747,grateful33,1325,144479,109,65,44
473840,grzy8ek,1296,141287,109,70,39
32122,guma1991,1255,136849,109,55,54
290918,gurp,1360,148241,109,58,51
30877,hudy5,1161,126588,109,50,59
222939,jaguar16,1220,133025,109,48,61
110333,jakawi3,1271,138596,109,73,36
3139,jerzy20a,1306,142430,109,62,47
38969,jestemlepsza,1435,156494,109,71,38
272928,jolyroger,1271,138593,109,66,43
156431,kacper8928,1071,116843,109,22,87
317513,kacper9,1150,125452,109,46,63
294534,kaczka28,1532,167088,109,71,38
341375,kaliniankos,1505,164095,109,80,29
327482,katarina3210,1196,130380,109,47,62
92680,kkaammiill91,1118,121969,109,49,60
7816,kopara121,1164,126957,109,53,56
20632,koscielski8,1133,123508,109,42,67
85706,kozlov,1110,121016,109,46,63
213161,ksg1467g,1467,160004,109,71,38
601877,kuba68,1069,116629,109,35,74
304226,legendarybear,1614,176011,109,90,19
250237,lilu987,1094,119246,109,35,74
248629,lokowana,1196,130391,109,58,51
109191,majkirs,1231,134285,109,47,62
42976,maliniak88,1312,143020,109,71,38
421913,massacrra,1476,160983,109,67,42
221205,max1450,1456,158708,109,73,36
325507,mmmmpiesio,1393,151918,109,71,38
84889,mpw9717g,1264,137850,109,67,42
367617,mtm2716g,1351,147302,109,78,31
382819,mwk8130g,1306,142442,109,55,54
73010,mysliwy78,1256,137003,109,48,61
529180,napiedalando,1195,130306,109,57,52
128363,nejwel,1186,129294,109,38,71
26473,new6,1501,163641,109,51,58
219874,niemaszszans,1476,160914,109,83,26
109811,nnm5809,1191,129881,109,49,60
497494,notforyou666,1178,128487,109,58,51
202585,nowygraczxd,1340,146112,109,59,50
158243,oskarxxd,1079,117678,109,30,79
107054,patafianix,1684,183624,109,82,27
231539,poguss,1273,138801,109,66,43
459994,prezestbg,1229,134017,109,53,56
111031,psf2754g,1360,148247,109,86,23
67350,sickness7,1320,143917,109,75,34
3719,skawinski,1409,153609,109,64,45
379963,slabalama,1415,154322,109,79,30
657795,sthileq,1271,138599,109,65,44
283914,sukitte,1263,137682,109,71,38
12412,sylwia1214,1285,140077,109,56,53
142925,szczepanola,1046,114064,109,22,87
36636,szyna6558,1169,127496,109,42,67
344336,tcc1325g,1335,145522,109,69,40
621905,teresamm,1227,133800,109,48,61
68211,thexara,1136,123904,109,43,66
509669,tmg2041g,1217,132658,109,59,50
165960,tst1999g,1277,139215,109,62,47
431514,ttc5434g,1608,175354,109,71,38
284729,urooczaa,1265,137942,109,85,24
346,von12,1430,155901,109,68,41
369127,vrurgh1,1507,164330,109,62,47
290457,vv8,1761,192056,109,90,19
422239,wnn8753g,1412,153916,109,71,38
474877,wrednasusz,1236,134750,109,65,44
516755,wsb3674g,1292,140832,109,67,42
553413,wtp1653g,1598,174271,109,79,30
655558,xxp11,1405,153157,109,93,16
190980,zorroo164,1231,134228,109,55,54
93706,0polska,1224,132246,108,37,71
75174,an1523,1239,133819,108,49,59
96454,art222111,1417,153069,108,80,28
56221,b1n1ol,1272,137425,108,52,56
196862,baran9322,1090,117745,108,26,82
491855,bbs5917g,1297,140147,108,57,51
205596,bdb9873g,1363,147227,108,65,43
125812,blackxxl,1687,182196,108,56,52
661975,botem,1491,161079,108,79,29
601073,brajan2009,1495,161483,108,66,42
24280,bratkuba,1018,110051,108,25,83
528793,bumbumpijerum,1663,179662,108,77,31
275973,butelkmleka,1258,135959,108,61,47
590209,capsl,1585,171209,108,71,37
335755,carrasco1910,1453,157017,108,63,45
216678,cfp5307g,1251,135126,108,52,56
608114,como3210,1312,141727,108,67,41
266231,d3x,1511,163274,108,64,44
122646,dawcio3002,1121,121080,108,38,70
204273,dcp2498g,1546,167060,108,88,20
302,dobermanss,1239,133860,108,44,64
38438,dpg9233,1188,128364,108,46,62
119433,drozda14,1271,137348,108,48,60
226349,dxse,1195,129079,108,75,33
414371,efuska,1126,121639,108,41,67
215765,eryk9929,1152,124438,108,36,72
172132,evelajna89,1171,126568,108,44,64
238645,eww97,1404,151642,108,66,42
21745,fankorony,1393,150481,108,64,44
470596,fcg1930g,1187,128271,108,39,69
60861,fistaszek84,1259,135983,108,58,50
146989,flaggis,1090,117774,108,25,83
463916,fmd6218g,1300,140501,108,68,40
503593,gdf677g,1091,117873,108,24,84
327285,gdf9593g,1235,133416,108,55,53
50138,gfgcfklhb,1413,152625,108,63,45
433297,gpf755g,1189,128511,108,47,61
76033,gregorek205,1174,126816,108,40,68
596620,icankiss,1694,183014,108,89,19
12362,iue,1275,137711,108,56,52
85396,karo159,1187,128258,108,50,58
19761,karoxoxo,1323,142893,108,59,49
24953,kutin1984,1195,129135,108,42,66
580466,kwp5457g,1179,127415,108,46,62
8971,loenergy,1520,164248,108,63,45
22174,lotnikzdeblin,1472,159041,108,53,55
245898,maaagdalenkaa,1177,127195,108,38,70
362053,magmakaj30,1365,147459,108,86,22
353645,malagadulce,1217,131523,108,57,51
607332,maniekzwd,1267,136932,108,58,50
8277,marta2907,1166,125974,108,41,67
25505,mat1eo,1308,141295,108,59,49
406580,matek87,1236,133580,108,62,46
435156,mateuszb2010,966,104328,108,7,101
171153,money2money,1314,141926,108,66,42
199748,mooni,1291,139529,108,62,46
644907,mp18pl,1185,128025,108,46,62
128496,nejwiszon,1206,130345,108,46,62
614478,nft9338g,1233,133190,108,56,52
270131,nosiustwa,1228,132718,108,51,57
33831,pem2r,1240,133947,108,29,79
235913,pfb1255g,1245,134541,108,62,46
228138,piotrek4891,1265,136625,108,62,46
386196,piotrusx95,1211,130802,108,64,44
136475,pitter24,1214,131146,108,51,57
39,plamka1oo,1319,142547,108,59,49
365035,pnm5216g,1523,164553,108,63,45
132192,poczatkujacy5,1518,163947,108,84,24
494600,psg3650g,1337,144440,108,43,65
108586,r2k2,1060,114520,108,30,78
518524,revy27,1136,122706,108,43,65
3446,rmn9323,1281,138381,108,63,45
65773,rozyczka78,1151,124402,108,40,68
477132,sds6074g,1504,162484,108,68,40
514953,sfc4227g,1219,131746,108,46,62
579790,sfn7514g,1249,134959,108,61,47
502796,sfw5961g,1204,130124,108,53,55
244823,silverhil,1213,131086,108,50,58
248337,skors,1266,136765,108,52,56
160576,slawek0702,1290,139349,108,66,42
428561,szeptem14,1251,135133,108,57,51
439352,tomeen,1368,147841,108,77,31
46643,tsunamifala,1224,132193,108,56,52
15869,umieszgrac85,1316,142128,108,53,55
192439,violamojbog,1103,119131,108,34,74
63766,vixadixa,1257,135840,108,57,51
651275,vrdc,1391,150312,108,56,52
222884,wdp8719g,1504,162525,108,71,37
91892,wfm3996,1216,131346,108,50,58
197613,wisn,1220,131810,108,49,59
6261,wojek94,1390,150129,108,85,23
47941,yyysawki,1330,143657,108,62,46
150442,zatrawa,1518,164050,108,82,26
7498,ziemniacek,1776,191828,108,87,21
118839,0pilka,1130,120916,107,40,67
143675,1amazing12,1222,130823,107,49,58
386483,88kuba88,1356,145194,107,58,49
52458,94piotrek,1336,142963,107,67,40
339665,984,1726,184759,107,90,17
333575,adas18krot,1196,128014,107,44,63
521775,adrrrrrr,1257,134583,107,71,36
1085,baldys83,1243,133076,107,58,49
182919,bandzior44,1185,126859,107,44,63
25090,bartexos,1332,142617,107,83,24
269505,bcg3682g,1219,130483,107,49,58
238245,bddsm,1222,130860,107,44,63
216186,bedzinslaskie,1509,161518,107,69,38
260742,beti05,1245,133219,107,54,53
62010,borek44,1141,122129,107,38,69
57928,buzka1710,1098,117543,107,28,79
638342,bzcbanda,1336,143022,107,47,60
1928,cathmaths,1359,145454,107,55,52
631134,cbd2523g,1157,123871,107,42,65
142155,chewz,1371,146744,107,64,43
386368,dct5861g,1255,134285,107,54,53
459539,ddc2936g,1411,150995,107,69,38
2782,dextryn,1189,127253,107,47,60
491647,dnn8974g,1426,152629,107,58,49
638270,dpm7265g,1337,143115,107,60,47
51813,dzziubekk,1102,117942,107,36,71
185592,flaku4,1357,145260,107,65,42
621029,fsw900g,1178,126063,107,43,64
653327,ftd5430g,1155,123643,107,52,55
85434,gda23,1197,128151,107,42,65
637046,georgiepaolo,1354,144964,107,57,50
268716,gepardziryk,1173,125512,107,44,63
401289,gkn2767g,1210,129576,107,55,52
112056,glodnydg,1298,138951,107,51,56
1747,gregorkrop,1206,129141,107,46,61
284821,heyday,1368,146396,107,58,49
48785,jaro82,1349,144394,107,58,49
140841,jestem1emo,1516,162231,107,66,41
122119,kadvars,1092,116868,107,24,83
102604,kapiszonik,1064,113898,107,20,87
254454,kapselpl,1178,126149,107,45,62
605317,karinoraa,1229,131575,107,53,54
45892,kasspergdansk,1344,143872,107,55,52
376334,kbn928,1071,114625,107,20,87
251666,kecaaj,1258,134681,107,43,64
371475,kotowzdz,1174,125678,107,45,62
4384,koxu123,1266,135503,107,44,63
618189,kozaktoja,1245,133310,107,56,51
297047,kubakap1899,1274,136396,107,76,31
625792,kurupka,1288,137903,107,63,44
643659,kwp1753g,1186,126942,107,42,65
181242,longsnake,1234,132093,107,53,54
57017,luck27,1320,141275,107,63,44
490619,m0nk,2164,231598,107,52,55
208774,maciejusss,1248,133635,107,47,60
2758,malykier,1480,158427,107,58,49
139495,mariuszstenka,1174,125699,107,49,58
211785,mat86tom,1187,127091,107,44,63
114297,mateusz2525,1064,113928,107,37,70
423301,mgk0adek,1158,123985,107,45,62
47309,michaelwai,1569,167905,107,72,35
187971,michcio73,1303,139472,107,63,44
15217,mlodyksiadz,1795,192096,107,81,26
531408,naharis,1577,168769,107,78,29
385050,niemgo,1247,133481,107,57,50
378589,nms3480g,1258,134623,107,61,46
29856,pandymacz,1437,153843,107,70,37
73741,pawelxbdg,1453,155495,107,46,61
639002,pbb3090g,1429,152962,107,98,9
120154,pchelka386,1143,122310,107,41,66
68086,perla091,1122,120090,107,29,78
430323,pgt6949g,1231,131818,107,54,53
31654,pink1floyd,1694,181295,107,66,41
380058,piotr1887,1079,115479,107,37,70
216939,piotrus200,1126,120534,107,34,73
205228,pisi11,1195,127926,107,56,51
489811,pkb8294g,1180,126276,107,43,64
339444,pkucman,1479,158293,107,76,31
590882,pnn502g,1273,136282,107,75,32
143355,point2500,1219,130526,107,36,71
154679,roobaczzek,1595,170735,107,76,31
68696,rypah,1148,122927,107,49,58
108369,scoiatelwa,1255,134297,107,48,59
36105,shacky,1261,134955,107,58,49
599043,skoczyc,1675,179272,107,79,28
78954,smoxy,1432,153231,107,66,41
330,sowinsiu,1383,148074,107,92,15
391091,spg3872g,1313,140591,107,68,39
116374,stinger123,1258,134610,107,45,62
64298,syrianin,1207,129156,107,47,60
177777,tbn239g,1258,134675,107,55,52
223363,tnm3043g,1347,144134,107,64,43
216478,tonik1,1271,136007,107,60,47
43057,tspl,1085,116198,107,43,64
365261,ttk930g,1358,145314,107,64,43
67703,tustysmok2012,1194,127778,107,52,55
88974,tysia1319,1206,129069,107,53,54
412719,vapieszpapiez,1342,143647,107,89,18
351292,viickix,1168,125046,107,46,61
106400,wgg3367,1063,113759,107,15,92
386414,wkupiesila100,1357,145283,107,72,35
239031,wsg5514g,1355,145071,107,73,34
533320,wwwwwnu,1205,128989,107,38,69
81361,x28x06,1328,142185,107,54,53
1107,xkooloox,1294,138469,107,46,61
69303,01romcio01,1181,125251,106,46,60
29538,18oo,1532,162479,106,54,52
551658,362,1317,139672,106,58,48
52698,annnndi,1381,146421,106,65,41
136251,apofis25,1224,129814,106,52,54
222890,aqnieszkaa,1298,137620,106,58,48
106820,arekszatan,1311,139071,106,59,47
110788,artuch,1112,117907,106,64,42
47391,baca1215,1281,135886,106,55,51
108573,bartekcy,1552,164516,106,93,13
86396,bieszacz,1124,119190,106,48,58
97343,bobik49,1232,130684,106,37,69
348494,boczio321,1354,143607,106,53,53
18114,bugatishelby,1365,144723,106,49,57
272561,bundowanie,1435,152199,106,66,40
621311,ccp1757g,987,104638,106,13,93
605644,cmf2548g,1227,130082,106,57,49
71523,czarnyxxv,1215,128821,106,37,69
117074,darektogey,1233,130781,106,54,52
595327,daria741,1268,134495,106,63,43
58464,daskanoess,1160,123012,106,47,59
170800,davcioxpompa,1252,132745,106,63,43
577897,demiusz,1368,145028,106,55,51
195705,dgs8322g,1249,132465,106,52,54
9607,dnj9558,1194,126650,106,47,59
49977,domeltomek,1388,147166,106,58,48
38095,dondadda,1489,157899,106,66,40
47956,dss902,1211,128381,106,57,49
314670,dtn7797g,1321,140083,106,70,36
57340,dumssie,1173,124422,106,45,61
399148,e36user,1275,135215,106,73,33
79101,fbbgf,1319,139823,106,65,41
103945,figo10,1304,138291,106,70,36
479453,fr3sh,1311,139015,106,56,50
386018,gastly,1595,169154,106,63,43
303448,ggm824g,1312,139083,106,80,26
446793,glamourrrr,1267,134322,106,67,39
323862,gosiazosi,1013,107384,106,13,93
343949,jan72usz72,1188,125997,106,43,63
167347,k0n,1432,151886,106,63,43
349485,k3tchup,1277,135395,106,53,53
89013,kamil605,1435,152121,106,50,56
608614,kamileczek99,1225,129884,106,60,46
457921,kamus68,1313,139225,106,64,42
55452,karasinio,1275,135239,106,65,41
327791,karasooo,1212,128487,106,65,41
1009,karatekx,1446,153359,106,69,37
409936,knb4895g,1300,137904,106,66,40
90995,kocikgosc,1301,137996,106,68,38
9770,kolus88,1164,123429,106,38,68
45154,koziamala,1182,125303,106,30,76
41257,kurak2002,1247,132268,106,56,50
266828,lastdevil,1487,157726,106,52,54
107841,lolexy,1210,128280,106,46,60
45153,macolek1234,1353,143513,106,76,30
233913,majkiwood,1325,140547,106,66,40
26847,makitong,1420,150606,106,83,23
73123,malami2002,1096,116228,106,38,68
424256,maliois,1219,129264,106,58,48
475761,malymen,1306,138524,106,57,49
62310,mandarynka19,1133,120138,106,44,62
325930,maryjaibulka,1189,126075,106,46,60
189592,mefiu8998,1240,131450,106,50,56
38270,megamocnywr,1429,151474,106,59,47
17,meldu77,1313,139187,106,46,60
236313,michal696,1225,129902,106,61,45
98975,michaljb,1255,133045,106,54,52
70356,mojzesz123,1220,129342,106,62,44
114615,monumentalnie,1048,111114,106,27,79
87030,mowiaomnie,1435,152148,106,63,43
555147,mpk8518g,1239,131349,106,71,35
444095,msc6176,1211,128375,106,53,53
193,ncw2030,1465,155350,106,65,41
168124,ni3ogarni3sz,2293,243079,106,54,52
117851,nieznanyjanek,1473,156192,106,56,50
525929,npw7749g,1401,148559,106,62,44
1200,penksa99,1369,145152,106,63,43
45724,piotruspan44,1246,132084,106,52,54
47477,plumpek10,1258,133392,106,51,55
441809,polscykibole,1650,174909,106,66,40
516328,pomarancza481,1291,136906,106,81,25
241210,promczak,1399,148338,106,63,43
138548,przegrasz00,1329,140960,106,51,55
15275,pyton36,1369,145150,106,56,50
377158,rav08,1184,125577,106,46,60
52706,reedigruba12,1130,119829,106,42,64
57550,reedii97,1214,128778,106,62,44
133277,reimu,1409,149437,106,56,50
47393,romeczka64,1152,122117,106,47,59
16349,rudolfik97,1119,118655,106,44,62
34063,salezjanie,1266,134299,106,63,43
185367,stuwies,1252,132817,106,49,57
83461,sunny,1306,138441,106,59,47
35453,sznurek99,1344,142508,106,50,56
186307,tkw6541g,1176,124691,106,59,47
93422,tomaszgollob,1345,142580,106,45,61
422284,tomcio845,1458,154572,106,69,37
5908,tomek29uk,1397,148186,106,71,35
484030,tpm2561g,1301,138001,106,73,33
412948,twm4519g,1210,128336,106,48,58
390130,whisu,1382,146556,106,63,43
540129,witoldinho3,1223,129659,106,59,47
329661,wpt2427g,1273,134946,106,59,47
660742,wudz4351,1340,142092,106,69,37
111592,xai,1374,145727,106,68,38
162054,xdrive,1441,152761,106,61,45
158748,yongtai7,1560,165433,106,68,38
275428,yosuo,1369,145131,106,42,64
152563,zimrahin,1445,153253,106,80,26
79602,0duzysprzet0,1463,153713,105,63,42
141054,1gibon,1115,117161,105,26,79
140848,adrianekk92,1262,132551,105,44,61
207882,anqaxq,1218,127936,105,43,62
181219,bnn2263g,1248,131105,105,54,51
589679,cdg8057g,1161,121989,105,41,64
607659,css5081g,1173,123210,105,43,62
33791,denypplayer,1200,126073,105,58,47
529545,endru1,1282,134626,105,50,55
124062,erykoza,1209,127016,105,63,42
521349,fanethegreat,1163,122178,105,45,60
620809,fmp4142g,1347,141497,105,65,40
639992,fnp7052g,1258,132186,105,62,43
15171,gkt2786,1237,129952,105,66,39
273919,goodgame222,979,102797,105,5,100
507249,gpt9207g,1331,139785,105,65,40
171472,grzegorzgr1,1340,140722,105,52,53
166633,h4rh4r,1270,133439,105,45,60
42575,hailsatan1,1253,131606,105,43,62
247230,jobanawarot,1340,140751,105,68,37
31174,jostam12,1481,155556,105,78,27
238471,juliaewa,1239,130196,105,69,36
1341,jullxd095,1111,116746,105,35,70
76716,kaczunia1,1352,142062,105,53,52
54733,kamillo21,1448,152048,105,88,17
423373,kbd8292,1246,130908,105,73,32
447788,kcm4864g,1375,144444,105,61,44
475400,kmk150g,1217,127842,105,44,61
301781,kroko25,1292,135695,105,50,55
248333,krychuosw,1203,126380,105,52,53
211,ksd1922dtm,1335,140213,105,50,55
109119,ktk8115g,1262,132561,105,53,52
341332,kwiat220,1181,124036,105,47,58
305067,lalina1,1288,135300,105,51,54
4849,lenyson,1202,126231,105,57,48
11108,lokapip22,1215,127588,105,53,52
329587,maestro30,1378,144729,105,62,43
42663,martini4,1322,138819,105,64,41
62499,martus1513,1444,151702,105,65,40
466585,mgs1873g,1213,127398,105,52,53
40832,michalpaw358,1369,143799,105,45,60
313444,mim80,1283,134729,105,53,52
192288,mkszlocisci,1379,144803,105,49,56
489614,msk1543g,1263,132654,105,56,49
49737,muffinie,1330,139723,105,85,20
41216,natwarzysiedz,1464,153807,105,55,50
2938,nowyqbk,1291,135585,105,51,54
608361,npn3387g,1328,139503,105,60,45
291586,o0ooooo0o,1452,152531,105,77,28
258553,pacostones,1233,129479,105,59,46
1242,pajdek22,1566,164517,105,49,56
644340,patx5,1261,132437,105,66,39
21957,pawel5pawel,1182,124181,105,27,78
10955,piocio4,1315,138150,105,56,49
403706,pkm2549g,1184,124331,105,49,56
106399,pmd5093,1330,139713,105,90,15
47293,ppb8619,1363,143189,105,53,52
515528,ppf2024g,1295,136025,105,50,55
200388,ppw1173g,1589,166926,105,84,21
68747,pstomek,1419,149058,105,57,48
55214,psyke102,1210,127056,105,51,54
207881,rymsi,1274,133843,105,54,51
163213,sandraax99,1223,128429,105,57,48
449448,shrek155,1193,125362,105,50,55
423374,skb6446,1118,117430,105,31,74
497097,smref,1404,147432,105,81,24
587304,spf655g,1194,125424,105,53,52
376019,ssjgodrose,1583,166226,105,85,20
64851,sus222,1283,134797,105,50,55
404,szpadyzordy,1346,141407,105,50,55
211106,tandeq,1545,162278,105,93,12
568955,tominum,1385,145435,105,54,51
394406,twk4032g,1298,136333,105,47,58
153733,vlej,1692,177718,105,69,36
112708,voxits,1252,131548,105,49,56
197586,wkw4228g,1295,135988,105,62,43
309811,wyrzygatemsie,1536,161282,105,68,37
436543,xdxboxjaja,1020,107175,105,12,93
34125,yassou4,1143,120074,105,37,68
625493,zajetywpracy,1469,154263,105,62,43
38640,ziemniaczkowo,1691,177640,105,88,17
72871,zoneczka69,1283,134720,105,65,40
48768,adixis,1259,131031,104,49,55
311620,antykruq,1587,165115,104,57,47
536722,bcm3449g,1198,124649,104,44,60
562798,bdw4928g,1294,134609,104,60,44
4122,biereaco,1306,135877,104,49,55
27959,bjpeen,1135,118140,104,35,69
318580,bmd6845g,1262,131348,104,65,39
39295,boamorte,1360,141530,104,74,30
488775,btb2058g,1424,148163,104,54,50
415666,cgw1195g,1276,132750,104,51,53
60440,chamak12,1253,130320,104,53,51
213106,chaos451,1251,130187,104,53,51
188354,chemtrails3,1150,119650,104,26,78
578489,cities,1677,174494,104,78,26
385819,coldasyou,1512,157318,104,56,48
246981,cornelcroi,1250,130072,104,57,47
428546,cypisczubek,1317,137017,104,64,40
257794,dektas,1190,123816,104,57,47
257425,dentoldentol,1240,128994,104,56,48
267959,dominika265,1126,117146,104,28,76
61344,eclipse2g,1509,157002,104,59,45
15873,evvenement,1558,162125,104,61,43
284443,ewelina9000,1388,144393,104,42,62
444640,fdf1599g,1221,126994,104,46,58
276343,fkf6908,1152,119833,104,37,67
622800,ftn2001g,1253,130348,104,56,48
640474,ftt6365g,1306,135860,104,64,40
605839,fwf2417g,1401,145798,104,74,30
107070,generalkutach,1374,142999,104,65,39
585013,golf,1436,149447,104,49,55
349701,gosiakokosia,1157,120352,104,50,54
143096,greenhaze,1563,162647,104,71,33
220854,gremx21,1348,140262,104,69,35
446272,grzegorzkm,1418,147568,104,102,2
31253,herbatalipton,1588,165246,104,66,38
30396,ivvin,1531,159327,104,58,46
214024,izako,1509,156943,104,64,40
592156,karol007,1317,137031,104,70,34
226780,kazik0081,1234,128413,104,49,55
627138,kbk207g,1199,124787,104,43,61
272297,kct7148g,1258,130927,104,59,45
512174,kochliwax,1365,141962,104,57,47
116128,korzen890,1266,131746,104,55,49
79488,koziolek666,1085,112854,104,21,83
17538,kozyra,1276,132807,104,62,42
240366,lapus,1816,188952,104,79,25
7231,lbeata,1344,139823,104,65,39
535567,leonix,1184,123215,104,45,59
380509,leonn23,1225,127474,104,47,57
36881,ligaklp,1744,181420,104,62,42
130162,magda1237,1135,118142,104,37,67
205537,magdalenka299,1256,130721,104,44,60
95230,malawa22,1293,134548,104,58,46
266164,maziaj,1168,121513,104,42,62
664464,mgs140g,1331,138471,104,56,48
246095,milenka1080,1008,104923,104,15,89
14101,mistrzkam,1506,156679,104,64,40
375684,mmisiiek12,1126,117105,104,30,74
370309,mwd3588g,1202,125032,104,44,60
28124,natkallka,1061,110400,104,33,71
326244,nbd7505g,1282,133389,104,54,50
631940,nbw2909g,1314,136753,104,54,50
61740,nemek13,1913,199019,104,75,29
512299,nfn7501g,1409,146621,104,66,38
491227,ngk5204g,1212,126085,104,56,48
16635,nosaty,2125,221019,104,77,27
212493,notoklapa,1199,124710,104,61,43
570739,ntn5233g,1407,146413,104,62,42
142641,ozx,1251,130194,104,58,46
16491,pastriczek,1281,133289,104,56,48
9489,pawel1206k,1311,136431,104,57,47
543705,pbc1484g,1360,141479,104,63,41
36014,permasylasimowo,1705,177341,104,64,40
548254,pkn1889,1353,140812,104,60,44
600436,pnb6554g,1229,127857,104,44,60
29444,popylacz,1367,142232,104,74,30
34600,poreotix,2020,210107,104,63,41
583936,ppb548g,1242,129259,104,59,45
363483,ppf828g,1256,130626,104,64,40
77176,przemek2191,1058,110072,104,18,86
209445,przemulek20,1235,128510,104,65,39
442746,ptd3158g,1380,143533,104,58,46
377194,r9445,1348,140222,104,55,49
135435,radekradd,1207,125578,104,55,49
28065,radomir77,1824,189737,104,67,37
71635,renik123,1172,121907,104,38,66
181074,rogo1337,1238,128814,104,56,48
59959,rolnik222,1110,115460,104,33,71
101967,ropaniszyn,1394,144995,104,86,18
204362,rozbujna,1262,131347,104,54,50
428118,sajkom,1134,117968,104,44,60
550362,sbc3841g,1225,127420,104,46,58
582640,scp1091g,1399,145511,104,57,47
401872,scs6459g,1455,151391,104,68,36
391633,sdc9380g,1145,119159,104,40,64
21636,serlukasz4444,1201,124910,104,47,57
119017,sitfak,1217,126581,104,36,68
428339,smk9715g,1385,144054,104,67,37
198180,snt4763,1179,122636,104,32,72
364652,stronczys,1505,156612,104,81,23
103121,tatabartosz,1302,135470,104,84,20
547407,tgbnji,1276,132755,104,56,48
260868,timessquare,1389,144488,104,70,34
202656,tmg3172g,1325,137848,104,67,37
284507,tomassoo,1408,146492,104,68,36
635846,tpd8419g,1322,137540,104,62,42
339256,tpm1688,1333,138722,104,66,38
293911,twc5142,1330,138356,104,65,39
296193,uniatarn0w,1343,139691,104,77,27
96675,veeja,1244,129410,104,43,61
56650,wariat8,1311,136354,104,59,45
216897,wilczekkkk,1241,129122,104,50,54
16151,wirus52,1145,119182,104,55,49
544104,ximena17,1267,131859,104,56,48
13700,xnoname,1956,203511,104,62,42
533737,zoiper,1141,118750,104,30,74
441206,zuzixnxx,1237,128651,104,56,48
138128,19malgosia79,1155,118989,103,31,72
225440,aaazzz11,1273,131180,103,48,55
249970,abccab1,1123,115678,103,38,65
26475,ad32,1229,126664,103,41,62
372053,adamski1900,1252,128967,103,56,47
318476,akyioshi,1243,128121,103,45,58
62648,alexandra2727,1108,114148,103,25,78
5005,alutka2333,1361,140193,103,73,30
62791,ananasek666,1245,128302,103,67,36
65622,annadomino,1178,121367,103,38,65
38072,asdewer,1159,119387,103,37,66
92606,bainer29,1304,134389,103,47,56
614497,bgf8792g,1239,127673,103,47,56
518736,bolobass,1207,124379,103,49,54
88140,cavasacky,1183,121948,103,58,45
279104,ccm4419g,1177,121233,103,44,59
387877,cgm3128g,1372,141326,103,63,40
338436,cilip14,1195,123133,103,46,57
436825,cizu,1279,131758,103,46,57
298511,ckm9567g,1233,127016,103,58,45
483948,cmb8292,1091,112421,103,37,66
408798,cmn5292g,1325,136572,103,67,36
380525,cnm3076g,1210,124671,103,49,54
219233,coumiesz,1471,151615,103,65,38
541080,csg8751g,1248,128552,103,51,52
528799,damian3344,1155,118994,103,37,66
594244,dbf2771g,1197,123380,103,45,58
590883,dbf353g,1144,117898,103,31,72
90774,deidara7891,1154,118881,103,34,69
505582,dominika20,1255,129298,103,57,46
420741,dominika365,1193,122938,103,48,55
156702,dominikorzech,1299,133846,103,88,15
40735,edikraus,1178,121378,103,79,24
29144,erlich,1273,131175,103,64,39
64029,extrachwast,1552,159896,103,55,48
539036,fsp6654g,1159,119380,103,43,60
83261,gabi10r,1264,130294,103,59,44
59083,galbatorix,2097,216023,103,74,29
655682,gkd540g,1103,113652,103,23,80
637439,gnn3073,1147,118144,103,49,54
121186,grajpfrutt,1316,135637,103,51,52
225167,gramwgimbie,1650,170001,103,80,23
116679,grzesiogabka,1352,139256,103,56,47
174168,howtoname,1362,140321,103,55,48
204300,ineesx,1184,122015,103,40,63
114436,izabela2601,1255,129359,103,61,42
31327,izamojapyza,1483,152844,103,68,35
389987,izydona,1534,158096,103,82,21
439,kaben,1361,140246,103,70,33
23043,kamilg1999,1232,126988,103,58,45
8531,karlydt,1168,120396,103,41,62
501968,kfb5150g,1132,116643,103,38,65
210424,kft7623g,1270,130817,103,45,58
201926,kollp530,952,98098,103,1,102
177316,kpb6143g,1442,148610,103,79,24
2257,krzysztof415,1204,124023,103,55,48
1410,kuchniajasna,1142,117725,103,39,64
416254,kwp7832g,1186,122260,103,46,57
222139,lalecznik,1343,138343,103,71,32
167209,leszcz0jestes,1728,178028,103,57,46
95166,ligakurnikapl,1639,168882,103,79,24
55892,lilinka29,1241,127837,103,67,36
583084,lliksag,1298,133718,103,60,43
643058,lucas151,1130,116478,103,34,69
143946,marius2607,1195,123109,103,45,58
440541,meandyou,1648,169830,103,77,26
19730,mentoss136,1298,133755,103,84,19
389966,merlin11,1242,127993,103,47,56
238360,mfm2777g,1286,132526,103,37,66
446273,mietkuz,981,101137,103,1,102
109502,misiucha85,1256,129384,103,52,51
10755,neosine00,1350,139119,103,61,42
226883,nff7250g,1509,155525,103,72,31
236326,nfs9267g,1255,129342,103,45,58
455931,nft3797g,1212,124899,103,43,60
535584,ngm1191g,1352,139337,103,57,46
101110,paweel80,1365,140687,103,63,40
61769,pawel525,1155,119029,103,27,76
486388,pdn8738g,1059,109090,103,4,99
40734,peti52,982,101149,103,23,80
25989,pkc7411,1216,125293,103,34,69
494536,psg4653g,1481,152568,103,60,43
172172,rafal1986,1197,123307,103,50,53
5829,ralph93,1393,143491,103,59,44
127133,ranq,2653,273292,103,14,89
92764,redley,1385,142683,103,57,46
392563,ribery077,1269,130744,103,58,45
94248,riverplateba,1507,155253,103,58,45
519587,sbg3445g,1196,123253,103,50,53
365539,sdc1685g,1091,112466,103,24,79
209438,ses12,1038,106920,103,20,83
394164,sff8224g,1371,141231,103,69,34
110226,smi77,1222,125878,103,44,59
213678,stig77,1338,137863,103,65,38
464891,tbc1378g,1341,138129,103,67,36
566163,tgm5300g,1324,136467,103,82,21
128532,tomaskor,1558,160525,103,76,27
229755,troyanhorses,1270,130852,103,55,48
35275,trywalmak,1681,173154,103,62,41
83355,ulbaard,1119,115272,103,28,75
100878,unlivedchiev,1253,129107,103,58,45
123901,victorieopeni,1200,123670,103,48,55
33671,w43,1207,124357,103,41,62
394489,wfm8730g,1222,125940,103,54,49
413048,wiarasileda,1367,140831,103,52,51
532205,wnf5494g,1214,125049,103,49,54
256349,wwp1742,1107,114029,103,33,70
300840,zaxscd3,1282,132049,103,42,61
631381,zegarmistrzu,1411,145378,103,61,42
248608,zryjecibanie,1615,166413,103,78,25
316858,0skam,1660,169373,102,68,34
372547,12081992,1257,128291,102,46,56
87205,123mirek,1210,123437,102,52,50
66779,3ym,1608,164025,102,66,36
330728,alfagostyn,1429,145824,102,60,42
301531,antyhazardino,1618,165132,102,73,29
649546,besos5000,1224,124895,102,60,42
238472,blackdickomg,1125,114778,102,33,69
55066,bodziojunior,1201,122565,102,49,53
68193,bombel1,1292,131827,102,54,48
27809,broodka,1202,122651,102,36,66
61004,bunik2701,1205,122959,102,57,45
398997,cbm8085,1311,133749,102,83,19
303690,cwp6177g,1220,124474,102,53,49
41546,danczer39,1372,140020,102,44,58
624810,dcg1781g,1271,129656,102,41,61
11771,dudi984,1202,122696,102,43,59
301397,ejzagramy,1413,144171,102,64,38
45829,emasku1,1222,124646,102,40,62
81403,entelygent,1834,187089,102,57,45
335301,ewelinka105,1366,139426,102,46,56
180541,exmixd,1224,124849,102,44,58
266419,fgs5598,1168,119148,102,31,71
125301,firstgun,1327,135422,102,52,50
181148,fnf516g,1308,133444,102,54,48
6537,garcia17,1214,123923,102,48,54
476476,gbt7497g,1407,143560,102,83,19
628692,gcd7222g,1187,121126,102,43,59
531412,gdg6552g,1246,127141,102,51,51
255873,gfk6780g,1207,123160,102,56,46
151799,giziol666,1385,141347,102,59,43
428969,gpk4725g,1320,134664,102,62,40
648214,gsw1042g,1217,124183,102,46,56
615880,gts6298g,1220,124440,102,47,55
146695,hanyschachar,2195,223955,102,45,57
117870,hilarem,1138,116164,102,36,66
272188,ionutojica,1275,130138,102,57,45
146641,iten13,1436,146508,102,67,35
102477,jasko90,1203,122763,102,40,62
210686,jenny1809,1186,121007,102,45,57
180929,joa4nna,1178,120207,102,37,65
220695,julciak1337,1351,137818,102,88,14
146421,kappapride,1197,122134,102,45,57
120995,karnal3,1238,126325,102,63,39
377506,kbg6482g,1375,140324,102,69,33
30713,koman,1455,148483,102,49,53
597778,kongurencja,1512,154293,102,68,34
229140,kordianm14,1190,121426,102,42,60
86436,kosmokwak,1307,133331,102,73,29
104842,kowaal93,1461,149114,102,61,41
71113,kubustychy,1109,113163,102,50,52
406309,kuman19,1237,126265,102,53,49
381360,lenkiewiczc,1226,125118,102,50,52
212492,livoorek,1138,116169,102,40,62
418422,lovato,1667,170058,102,77,25
505121,magickris,1615,164790,102,66,36
635,mamcisnienie,1604,163673,102,75,27
631970,manda1988,1230,125554,102,42,60
247834,mar010,1203,122776,102,53,49
246150,maslopolskie,1365,139330,102,53,49
659148,matik525,1285,131095,102,56,46
368430,mgf2888g,1157,118110,102,34,68
603265,mjk129,1147,117032,102,37,65
290890,mlodawiara1,1432,146145,102,61,41
476149,mmm3994g,1293,131963,102,48,54
214342,mms1152g,1312,133878,102,72,30
9789,moniek325,1377,140488,102,54,48
120321,motoryzant8,1220,124529,102,47,55
295349,ndt6494g,1210,123426,102,48,54
131119,newilos,1227,125173,102,45,57
390611,ngt8257g,1310,133720,102,82,20
157190,nikox,1286,131200,102,52,50
123325,nogard09,1110,113236,102,36,66
434837,nps1188g,1295,132101,102,61,41
222579,nxsxb,1134,115758,102,35,67
96841,onyksd,1477,150744,102,85,17
18605,p1siontgroszy,1390,141811,102,65,37
27069,pabu97,1302,132883,102,61,41
68773,patryko243,1191,121492,102,43,59
2625,pawel0923,1207,123181,102,51,51
139676,pawelkaju,1290,131650,102,55,47
382149,pbk4749g,1377,140479,102,64,38
193291,pdp4030,1167,119062,102,47,55
13441,pierwszagra21,1224,124855,102,42,60
75050,pijesznapsa,1444,147301,102,62,40
89181,pitollo93,1345,137241,102,67,35
40989,poczatkujacy,2003,204318,102,62,40
565339,polskikosmit,1120,114278,102,30,72
7479,qrka80,1367,139463,102,56,46
8948,radekum,1544,157542,102,51,51
2424,riczard18,1247,127282,102,53,49
67697,riq10,1296,132232,102,53,49
58419,robaczekk87,1611,164412,102,73,29
402003,rolnik9,1442,147180,102,70,32
142570,rybakon,1495,152561,102,89,13
101708,sfgame22,1729,176403,102,91,11
592363,skk5040g,1335,136194,102,59,43
163931,sloogar,1222,124742,102,61,41
54349,smutny4u,1465,149466,102,56,46
626576,stf8888g,1452,148150,102,71,31
259530,sven1010,1199,122371,102,49,53
10060,sztylety,1349,137621,102,53,49
411271,tbc4827g,1252,127718,102,53,49
18036,tbwera,1343,137083,102,50,52
118534,tcm2076,1017,103739,102,15,87
120990,thr33,1606,163867,102,64,38
123105,topmazur,1354,138170,102,58,44
433884,twb8627g,1253,127825,102,49,53
66592,uczek1,1181,120503,102,47,55
152792,ulvheidine,1206,123046,102,44,58
607874,waskimihu,1174,119806,102,46,56
3229,weramrr,1424,145304,102,63,39
355952,weronika2205,1159,118286,102,47,55
1198,whatdoyoumind,1641,167455,102,53,49
136803,yellorangred,1371,139908,102,56,46
149075,zabrzanin,1562,159404,102,67,35
287432,zajcwielkanoc,1560,159218,102,61,41
76332,zehn,1256,128172,102,44,58
123797,zibi97,1222,124698,102,43,59
395022,ziolo111,1163,118695,102,41,61
118442,1szot1gol,1352,136640,101,53,48
362919,23an,1240,125316,101,55,46
30185,300ruszki,1413,142791,101,76,25
197621,adekw,1278,129142,101,53,48
602685,adiemde,1391,140509,101,51,50
215452,aldona1893,1389,140312,101,76,25
158999,artur1995,1377,139092,101,73,28
163930,artxerio,1152,116401,101,40,61
32008,bahamut,1386,140017,101,54,47
264162,bfk3724g,1327,134123,101,53,48
81347,bigburn,1557,157303,101,40,61
443434,bot123,1537,155237,101,61,40
643448,botak23,1375,138943,101,57,44
170781,cbs5976g,1413,142753,101,77,24
303752,cdf4988g,1617,163317,101,67,34
313961,chabr5,1480,149495,101,65,36
402852,cienki2,1444,145933,101,70,31
131091,clark99,1410,142447,101,52,49
124889,cola25,1063,107379,101,31,70
632632,czekoladaaaaa,1159,117158,101,36,65
12407,czokler92,1396,141087,101,61,40
125650,damianeksz5,1235,124745,101,58,43
434677,dario1989,1234,124653,101,65,36
86829,darusss24,1219,123185,101,38,63
149617,dns6217g,1303,131675,101,58,43
30581,dolarik9,1329,134314,101,76,25
256974,doniiek,1208,122108,101,44,57
331468,dwt684g,1276,128883,101,65,36
80283,elvis026,1265,127774,101,48,53
121430,ewelinastnc,1093,110400,101,25,76
35659,fabianek2207,1141,115277,101,32,69
31531,filip1916,1230,124267,101,43,58
183855,filiprudy,1306,131977,101,56,45
565000,fks4740,1226,123857,101,61,40
368382,fnd4616g,1426,144064,101,66,35
33859,fsf7895,1234,124690,101,62,39
216408,gcn4744g,1263,127636,101,47,54
511620,ggg6941g,1424,143912,101,59,42
61816,giverwsp1,1333,134713,101,54,47
401298,gpiro,1461,147649,101,63,38
79125,grzesiuw123,1337,135070,101,71,30
243848,gsm1927g,1183,119534,101,37,64
416099,hungryforever,1064,107488,101,26,75
584,idemmm,1256,126866,101,53,48
86115,iustusia,1093,110458,101,36,65
54325,jakub0100,1280,129379,101,56,45
19871,karmelekw,1152,116352,101,47,54
86325,kieniu321,1151,116269,101,40,61
362436,kleo320,1244,125712,101,61,40
40119,kogut0,1380,139459,101,43,58
15170,kojskowojsko,1394,140848,101,48,53
5041,koolorowaxd,1374,138780,101,52,49
386462,kopytkozadnie,1399,141352,101,82,19
50172,kosmonalta123,1213,122602,101,46,55
28328,kosto999,1216,122864,101,56,45
54478,krowka159,1178,118992,101,46,55
542833,kryptonczyk,1527,154282,101,64,37
489147,kwm9196g,1228,124118,101,49,52
26257,l0tkani,1638,165518,101,62,39
111904,lecmy,1626,164325,101,68,33
14178,loreh,1375,138886,101,48,53
377,lubenia,1288,130168,101,49,52
82073,machnio1,1207,122002,101,42,59
526451,margol6673,1431,144570,101,58,43
526808,mateostrzelec,1524,153994,101,63,38
54358,mateuszg23,1345,135927,101,55,46
108987,mcc8491,1226,123925,101,56,45
231754,mff1832g,1055,106594,101,18,83
65658,michalidomini,1237,124974,101,46,55
22335,michalszajter,1243,125631,101,64,37
201010,michu22c,1229,124165,101,55,46
47510,milurit,1411,142546,101,74,27
649163,mpd1913g,1222,123425,101,41,60
151594,mtb8320,1200,121295,101,47,54
565400,mwp4835g,1221,123399,101,51,50
103681,naaataaa1,1002,101275,101,9,92
502869,nct1776,1165,117716,101,44,57
155813,nfn5658g,1308,132173,101,58,43
231367,nutellaaaaa,1188,120011,101,42,59
67167,ojejeje,1323,133666,101,45,56
180758,owocelasu2,1713,173092,101,80,21
20218,paprycia1915,1053,106432,101,19,82
1146,paszkwilant,1459,147421,101,59,42
51731,patvycja,1206,121831,101,56,45
49861,pier93,1408,142217,101,73,28
301791,pom17,1569,158472,101,91,10
656773,ptn761g,1454,146877,101,62,39
2655,puchacz38,1273,128642,101,36,65
13071,puma016,1241,125347,101,41,60
381504,redfajazgred,1436,145079,101,62,39
20625,sabinaxx,1115,112683,101,24,77
115354,sandrella77,1209,122138,101,56,45
149294,saqsaq,1203,121553,101,33,68
189597,seulgi,1380,139413,101,49,52
428117,skymiki11,1180,119204,101,55,46
7406,sraytashma,1443,145776,101,41,60
266581,szymon531,1466,148152,101,101,0
18544,teken2212,1268,128097,101,79,22
385608,tfn3967g,1252,126522,101,61,40
107624,thebart3kk,1176,118857,101,47,54
61340,tiptoe,1149,116052,101,36,65
46112,tomb80,1370,138419,101,70,31
233517,tomekwegl,1276,128895,101,61,40
4631,trufel99,1273,128655,101,55,46
66176,vegeta666,1418,143275,101,67,34
142113,vggthnjgtfcd,1213,122553,101,44,57
234252,vivar,1305,131886,101,61,40
446966,wfs2620,1190,120234,101,57,44
398331,wkw7253g,1425,144025,101,68,33
316584,wlczek,1139,115066,101,33,68
347376,wms659g,1209,122192,101,53,48
392256,wnn8012g,1049,105963,101,17,84
174638,wolaber,1595,161125,101,47,54
167806,wrestler,1192,120480,101,46,55
